id,burst time,inital burst time,arrival time,priority,wait time,turnaround time,id,Start,Finish
1,0,1,1,13,26,27,1,27,28
2,0,25,1,71,1,26,2,2,27
3,0,1,1,82,0,1,3,1,2
4,0,2,2,5,27,29,4,29,31
5,0,1,2,122,26,27,5,28,29
6,0,3,5,100,27,30,6,32,35
7,0,1,4,53,27,28,7,31,32
8,0,1,8,63,27,28,8,35,36
9,0,1,11,35,26,27,9,37,38
10,0,1,9,73,27,28,10,36,37
