id,burst time,initial burst time,arrival time,final priority,wait time,turnaround time,response time,total CPU time,total I/O time,times worked on,start 1,finish 1,priority 1,start 2,finish 2,priority 2,start 3,finish 3,priority 3,io start 0,io end 0
999,1,1,18,9,10094,10098,9953,4,10,2,9970,9971,9,10113,10116,9,-1,-1,-1,9971,9981
998,8,8,27,50,114,133,42,19,3,2,61,69,50,149,160,50,-1,-1,-1,69,72
997,1,1,32,6,10948,10951,10808,3,11,2,10839,10840,6,10981,10983,6,-1,-1,-1,10840,10852
996,8,8,30,8,10351,10370,10259,19,1,2,10281,10289,8,10389,10400,8,-1,-1,-1,10289,10290
995,3,3,25,11,9624,9628,9514,4,11,2,9536,9539,11,9652,9653,11,-1,-1,-1,9539,9551
994,1,1,3,2,11655,11659,11527,4,10,2,11529,11530,2,11659,11662,2,-1,-1,-1,11530,11541
993,8,8,13,23,6751,6767,6665,16,2,2,6670,6678,23,6772,6780,23,-1,-1,-1,6678,6680
992,1,1,48,28,5746,5749,5704,3,9,2,5751,5752,28,5795,5797,28,-1,-1,-1,5752,5763
991,12,12,11,40,2764,2786,2621,22,2,2,2620,2632,40,2787,2797,40,-1,-1,-1,2632,2634
990,1,1,39,37,3680,3684,3547,4,12,2,3585,3586,37,3720,3723,37,-1,-1,-1,3586,3599
989,2,2,37,38,3399,3404,3271,5,9,2,3306,3308,38,3438,3441,38,-1,-1,-1,3308,3317
988,1,1,7,8,10356,10359,10242,3,11,2,10248,10249,8,10364,10366,8,-1,-1,-1,10249,10261
987,11,11,47,9,10121,10144,10012,23,2,2,10048,10059,9,10179,10191,9,-1,-1,-1,10059,10061
986,3,3,24,21,7321,7325,7170,4,11,2,7191,7194,21,7348,7349,21,-1,-1,-1,7194,7207
985,3,3,44,29,5651,5656,5543,5,9,2,5584,5587,29,5698,5700,29,-1,-1,-1,5587,5596
984,9,9,40,45,1501,1519,1421,18,2,2,1452,1461,45,1550,1559,45,-1,-1,-1,1461,1464
983,8,8,27,29,5604,5621,5515,17,1,2,5534,5542,29,5639,5648,29,-1,-1,-1,5542,5543
982,2,2,35,31,5171,5176,5038,5,11,2,5071,5073,31,5208,5211,31,-1,-1,-1,5073,5084
981,10,10,10,40,2732,2753,2586,21,3,2,2586,2596,40,2752,2763,40,-1,-1,-1,2596,2599
980,12,12,40,21,7344,7364,7217,20,3,2,7245,7257,21,7396,7404,21,-1,-1,-1,7257,7260
979,1,1,24,48,643,647,519,4,11,2,542,543,48,668,671,48,-1,-1,-1,543,554
978,11,11,15,12,9329,9350,9220,21,3,2,9224,9235,12,9355,9365,12,-1,-1,-1,9235,9238
977,3,3,44,2,11706,11712,11574,6,8,2,11615,11618,2,11753,11756,2,-1,-1,-1,11618,11627
976,12,12,50,43,2048,2070,1916,22,1,2,1954,1966,43,2110,2120,43,-1,-1,-1,1966,1967
975,9,9,50,34,4419,4436,4298,17,2,2,4339,4348,34,4478,4486,34,-1,-1,-1,4348,4351
974,10,10,45,40,2799,2819,2656,20,1,2,2691,2701,40,2854,2864,40,-1,-1,-1,2701,2702
973,1,1,39,15,8582,8584,8526,2,11,2,8564,8565,15,8622,8623,15,-1,-1,-1,8565,8577
972,11,11,43,5,11118,11140,11050,22,3,2,11082,11093,5,11172,11183,5,-1,-1,-1,11093,11097
971,2,2,1,12,9334,9337,9210,3,9,2,9209,9211,12,9337,9338,12,-1,-1,-1,9211,9220
970,1,1,43,38,3428,3432,3297,4,8,2,3339,3340,38,3472,3475,38,-1,-1,-1,3340,3349
969,8,8,3,2,11640,11656,11526,16,2,2,11521,11529,2,11651,11659,2,-1,-1,-1,11529,11531
968,2,2,37,22,7053,7056,6906,3,10,2,6941,6943,22,7092,7093,22,-1,-1,-1,6943,6954
967,12,12,43,23,6767,6791,6696,24,3,2,6727,6739,23,6822,6834,23,-1,-1,-1,6739,6742
966,12,12,16,46,1242,1266,1089,24,1,2,1093,1105,46,1270,1282,46,-1,-1,-1,1105,1106
965,9,9,4,8,10329,10347,10234,18,2,2,10229,10238,8,10342,10351,8,-1,-1,-1,10238,10241
964,12,12,48,47,966,988,815,22,3,2,851,863,47,1026,1036,47,-1,-1,-1,863,866
963,2,2,44,43,2063,2066,1906,3,10,2,1948,1950,43,2109,2110,43,-1,-1,-1,1950,1961
962,2,2,45,35,4140,4145,4012,5,10,2,4055,4057,35,4187,4190,35,-1,-1,-1,4057,4068
961,1,1,1,22,6984,6987,6834,3,11,2,6834,6835,22,6986,6988,22,-1,-1,-1,6835,6846
960,3,3,37,16,8425,8430,8365,5,8,2,8399,8402,16,8465,8467,16,-1,-1,-1,8402,8411
959,2,2,2,32,4832,4837,4701,5,11,2,4701,4703,32,4836,4839,32,-1,-1,-1,4703,4715
958,10,10,18,32,4820,4840,4707,20,3,2,4715,4725,32,4848,4858,32,-1,-1,-1,4725,4728
957,10,10,32,20,7544,7563,7456,19,3,2,7478,7488,20,7586,7595,20,-1,-1,-1,7488,7491
956,3,3,35,34,4394,4399,4258,5,10,2,4290,4293,34,4432,4434,34,-1,-1,-1,4293,4303
955,9,9,9,38,3353,3371,3241,18,1,2,3241,3250,38,3371,3380,38,-1,-1,-1,3250,3251
954,9,9,29,47,932,952,785,20,3,2,805,814,47,970,981,47,-1,-1,-1,814,817
953,11,11,20,18,7893,7913,7783,20,3,2,7792,7803,18,7924,7933,18,-1,-1,-1,7803,7806
952,11,11,32,49,341,364,228,23,2,2,249,260,49,384,396,49,-1,-1,-1,260,262
951,2,2,20,7,10623,10627,10481,4,10,2,10499,10501,7,10645,10647,7,-1,-1,-1,10501,10512
950,12,12,14,4,11241,11265,11201,24,2,2,11203,11215,4,11267,11279,4,-1,-1,-1,11215,11217
949,11,11,40,30,5410,5430,5317,20,1,2,5346,5357,30,5461,5470,30,-1,-1,-1,5357,5358
948,10,10,22,33,4595,4613,4509,18,2,2,4521,4531,33,4627,4635,33,-1,-1,-1,4531,4533
947,8,8,37,18,7918,7938,7808,20,2,2,7837,7845,18,7963,7975,18,-1,-1,-1,7845,7849
946,11,11,2,24,6500,6521,6396,21,2,2,6387,6398,24,6513,6523,24,-1,-1,-1,6398,6400
945,1,1,25,44,1730,1733,1621,3,8,2,1645,1646,44,1756,1758,44,-1,-1,-1,1646,1655
944,9,9,44,31,5174,5193,5051,19,1,2,5086,5095,31,5227,5237,31,-1,-1,-1,5095,5096
943,1,1,32,35,4119,4122,3985,3,11,2,4016,4017,35,4152,4154,35,-1,-1,-1,4017,4029
942,10,10,11,39,3051,3072,2893,21,1,2,2894,2904,39,3072,3083,39,-1,-1,-1,2904,2906
941,8,8,39,6,10948,10964,10822,16,1,2,10853,10861,6,10995,11003,6,-1,-1,-1,10861,10862
940,8,8,47,19,7686,7705,7646,19,1,2,7685,7693,19,7741,7752,19,-1,-1,-1,7693,7694
939,2,2,21,14,8825,8829,8666,4,9,2,8685,8687,14,8848,8850,14,-1,-1,-1,8687,8696
938,8,8,39,32,4874,4890,4755,16,1,2,4786,4794,32,4921,4929,32,-1,-1,-1,4794,4795
937,2,2,12,20,7556,7561,7453,5,10,2,7463,7465,20,7570,7573,20,-1,-1,-1,7465,7476
936,8,8,7,44,1681,1697,1591,16,1,2,1590,1598,44,1696,1704,44,-1,-1,-1,1598,1599
935,3,3,3,50,11,17,3,6,9,2,3,6,50,17,20,50,-1,-1,-1,6,16
934,3,3,34,33,4628,4632,4534,4,12,2,4565,4568,33,4665,4666,33,-1,-1,-1,4568,4580
933,11,11,28,22,7013,7032,6874,19,3,2,6891,6902,22,7052,7060,22,-1,-1,-1,6902,6905
932,8,8,20,44,1703,1720,1611,17,2,2,1623,1631,44,1731,1740,44,-1,-1,-1,1631,1633
931,11,11,40,7,10652,10672,10538,20,2,2,10567,10578,7,10703,10712,7,-1,-1,-1,10578,10580
930,10,10,14,17,8186,8205,8040,19,3,2,8044,8054,17,8210,8219,17,-1,-1,-1,8054,8057
929,10,10,41,1,11853,11873,11808,20,2,2,11839,11849,1,11904,11914,1,-1,-1,-1,11849,11851
928,8,8,4,9,10070,10086,9941,16,2,2,9937,9945,9,10082,10090,9,-1,-1,-1,9945,9947
927,1,1,14,20,7567,7569,7454,2,9,2,7467,7468,20,7582,7583,20,-1,-1,-1,7468,7479
926,3,3,45,26,6200,6204,6144,4,9,2,6186,6189,26,6248,6249,26,-1,-1,-1,6189,6199
925,9,9,17,14,8798,8819,8657,21,3,2,8665,8674,14,8824,8836,14,-1,-1,-1,8674,8678
924,12,12,27,1,11844,11865,11800,21,1,2,11815,11827,1,11883,11892,1,-1,-1,-1,11827,11828
923,2,2,20,17,8219,8223,8065,4,9,2,8083,8085,17,8241,8243,17,-1,-1,-1,8085,8094
922,9,9,16,11,9601,9620,9518,19,1,2,9525,9534,11,9626,9636,11,-1,-1,-1,9534,9535
921,8,8,11,30,5383,5401,5278,18,3,2,5281,5289,30,5402,5412,30,-1,-1,-1,5289,5292
920,11,11,3,25,6303,6322,6257,19,2,2,6249,6260,25,6317,6325,25,-1,-1,-1,6260,6262
919,2,2,33,14,8884,8889,8718,5,12,2,8749,8751,14,8919,8922,14,-1,-1,-1,8751,8763
918,9,9,5,8,10340,10357,10243,17,3,2,10239,10248,8,10354,10362,8,-1,-1,-1,10248,10251
917,2,2,20,17,8221,8226,8063,5,10,2,8081,8083,17,8243,8246,17,-1,-1,-1,8083,8095
916,2,2,41,46,1320,1325,1158,5,9,2,1197,1199,46,1363,1366,46,-1,-1,-1,1199,1209
915,9,9,45,34,4411,4431,4291,20,1,2,4327,4336,34,4465,4476,34,-1,-1,-1,4336,4337
914,1,1,46,48,651,655,522,4,8,2,567,568,48,698,701,48,-1,-1,-1,568,577
913,3,3,42,41,2479,2484,2389,5,9,2,2428,2431,41,2524,2526,41,-1,-1,-1,2431,2441
912,1,1,48,2,11738,11742,11603,4,12,2,11650,11651,2,11787,11790,2,-1,-1,-1,11651,11664
911,12,12,26,46,1270,1294,1119,24,3,2,1133,1145,46,1308,1320,46,-1,-1,-1,1145,1148
910,3,3,17,28,5757,5762,5717,5,10,2,5731,5734,28,5777,5779,28,-1,-1,-1,5734,5744
909,9,9,19,12,9346,9364,9236,18,1,2,9246,9255,12,9374,9383,12,-1,-1,-1,9255,9256
908,3,3,49,40,2818,2822,2658,4,12,2,2704,2707,40,2870,2871,40,-1,-1,-1,2707,2720
907,11,11,50,9,10141,10164,10032,23,3,2,10071,10082,9,10202,10214,9,-1,-1,-1,10082,10085
906,3,3,7,35,4070,4075,3940,5,8,2,3944,3947,35,4080,4082,35,-1,-1,-1,3947,3955
905,12,12,29,37,3641,3665,3541,24,2,2,3558,3570,37,3682,3694,37,-1,-1,-1,3570,3573
904,1,1,45,40,2818,2822,2646,4,11,2,2690,2691,40,2864,2867,40,-1,-1,-1,2691,2703
903,3,3,47,8,10392,10397,10280,5,10,2,10324,10327,8,10442,10444,8,-1,-1,-1,10327,10337
902,11,11,43,11,9613,9635,9531,22,3,2,9563,9574,11,9667,9678,11,-1,-1,-1,9574,9578
901,3,3,37,13,9153,9159,9029,6,10,2,9063,9066,13,9193,9196,13,-1,-1,-1,9066,9076
900,10,10,34,33,4611,4631,4531,20,3,2,4555,4565,33,4655,4665,33,-1,-1,-1,4565,4568
899,11,11,48,9,10133,10154,10023,21,1,2,10060,10071,9,10192,10202,9,-1,-1,-1,10071,10073
898,1,1,50,38,3425,3428,3294,3,12,2,3343,3344,38,3476,3478,38,-1,-1,-1,3344,3357
897,1,1,36,31,5174,5178,5038,4,11,2,5073,5074,31,5211,5214,31,-1,-1,-1,5074,5086
896,3,3,2,30,5390,5396,5266,6,12,2,5265,5268,30,5395,5398,30,-1,-1,-1,5268,5280
895,10,10,24,47,913,935,771,22,2,2,785,795,47,947,959,47,-1,-1,-1,795,797
894,1,1,4,23,6734,6738,6636,4,8,2,6639,6640,23,6739,6742,23,-1,-1,-1,6640,6648
893,9,9,1,47,853,872,1,19,3,3,1,2,47,701,709,47,863,873,47,709,712
892,12,12,20,49,340,364,229,24,2,2,237,249,49,372,384,49,-1,-1,-1,249,251
891,9,9,24,22,6990,7011,6851,21,3,2,6866,6875,22,7023,7035,22,-1,-1,-1,6875,6878
890,11,11,18,50,53,72,13,19,3,2,20,31,50,82,90,50,-1,-1,-1,31,34
889,9,9,31,2,11679,11700,11566,21,3,2,11588,11597,2,11719,11731,2,-1,-1,-1,11597,11600
888,2,2,30,16,8423,8426,8360,3,11,2,8388,8390,16,8455,8456,16,-1,-1,-1,8390,8402
887,12,12,12,31,5110,5134,4987,24,2,2,4987,4999,31,5134,5146,31,-1,-1,-1,4999,5001
886,3,3,27,2,11677,11682,11547,5,11,2,11571,11574,2,11707,11709,2,-1,-1,-1,11574,11586
885,10,10,27,35,4076,4096,3964,20,2,2,3981,3991,35,4113,4123,35,-1,-1,-1,3991,3993
884,3,3,36,37,3666,3672,3546,6,12,2,3579,3582,37,3705,3708,37,-1,-1,-1,3582,3594
883,12,12,29,18,7909,7930,7805,21,2,2,7822,7834,18,7950,7959,18,-1,-1,-1,7834,7837
882,2,2,44,8,10378,10383,10268,5,9,2,10310,10312,8,10424,10427,8,-1,-1,-1,10312,10322
881,11,11,3,43,1952,1975,1810,23,3,2,1802,1813,43,1966,1978,43,-1,-1,-1,1813,1816
880,12,12,27,46,1289,1312,1142,23,3,2,1157,1169,46,1328,1339,46,-1,-1,-1,1169,1172
879,2,2,1,41,2449,2453,2345,4,9,2,2344,2346,41,2452,2454,41,-1,-1,-1,2346,2355
878,2,2,3,6,10875,10880,10735,5,8,2,10736,10738,6,10880,10883,6,-1,-1,-1,10738,10747
877,11,11,17,8,10338,10358,10245,20,3,2,10251,10262,8,10366,10375,8,-1,-1,-1,10262,10265
876,12,12,5,13,9072,9093,8968,21,3,2,8961,8973,13,9089,9098,13,-1,-1,-1,8973,8976
875,10,10,9,46,1225,1245,1069,20,2,2,1068,1078,46,1244,1254,46,-1,-1,-1,1078,1080
874,2,2,48,32,4903,4907,4770,4,11,2,4816,4818,32,4953,4955,32,-1,-1,-1,4818,4829
873,10,10,15,17,8194,8214,8049,20,3,2,8054,8064,17,8219,8229,17,-1,-1,-1,8064,8067
872,8,8,31,8,10364,10380,10266,16,1,2,10289,10297,8,10403,10411,8,-1,-1,-1,10297,10298
871,12,12,45,29,5643,5665,5554,22,2,2,5587,5599,29,5700,5710,29,-1,-1,-1,5599,5601
870,10,10,42,9,10102,10120,9986,18,3,2,10018,10028,9,10154,10162,9,-1,-1,-1,10028,10031
869,3,3,33,6,10947,10951,10810,4,11,2,10840,10843,6,10983,10984,6,-1,-1,-1,10843,10855
868,12,12,19,9,10086,10107,9964,21,3,2,9971,9983,9,10117,10126,9,-1,-1,-1,9983,9987
867,3,3,12,41,2448,2453,2344,5,9,2,2353,2356,41,2463,2465,41,-1,-1,-1,2356,2367
866,2,2,49,30,5443,5446,5329,3,10,2,5376,5378,30,5494,5495,30,-1,-1,-1,5378,5388
865,3,3,34,39,3168,3173,3002,5,8,2,3033,3036,39,3205,3207,39,-1,-1,-1,3036,3044
864,2,2,17,24,6547,6552,6425,5,10,2,6440,6442,24,6566,6569,24,-1,-1,-1,6442,6453
863,1,1,26,21,7322,7326,7170,4,10,2,7195,7196,21,7349,7352,21,-1,-1,-1,7196,7208
862,9,9,30,24,6545,6562,6443,17,1,2,6464,6473,24,6584,6592,24,-1,-1,-1,6473,6474
861,12,12,45,4,11254,11274,11211,20,1,2,11244,11256,4,11311,11319,4,-1,-1,-1,11256,11257
860,3,3,27,23,6765,6769,6667,4,9,2,6691,6694,23,6795,6796,23,-1,-1,-1,6694,6704
859,1,1,29,27,6006,6010,5845,4,11,2,5873,5874,27,6036,6039,27,-1,-1,-1,5874,5886
858,8,8,14,7,10602,10621,10473,19,1,2,10479,10487,7,10624,10635,7,-1,-1,-1,10487,10488
857,2,2,15,50,33,36,2,3,8,2,15,17,50,50,51,50,-1,-1,-1,17,26
856,2,2,40,36,3889,3894,3787,5,9,2,3825,3827,36,3931,3934,36,-1,-1,-1,3827,3837
855,1,1,11,15,8571,8573,8499,2,9,2,8509,8510,15,8583,8584,15,-1,-1,-1,8510,8521
854,11,11,33,15,8570,8589,8531,19,3,2,8553,8564,15,8614,8622,15,-1,-1,-1,8564,8568
853,11,11,30,22,7030,7050,6893,20,1,2,6912,6923,22,7071,7080,22,-1,-1,-1,6923,6924
852,2,2,32,25,6345,6348,6282,3,8,2,6312,6314,25,6379,6380,25,-1,-1,-1,6314,6322
851,1,1,13,48,599,602,479,3,10,2,491,492,48,613,615,48,-1,-1,-1,492,503
850,3,3,6,19,7715,7720,7659,5,9,2,7662,7665,19,7724,7726,19,-1,-1,-1,7665,7675
849,10,10,38,18,7927,7947,7817,20,3,2,7845,7855,18,7975,7985,18,-1,-1,-1,7855,7858
848,2,2,25,6,10948,10952,10810,4,11,2,10833,10835,6,10975,10977,6,-1,-1,-1,10835,10847
847,11,11,8,9,10079,10101,9957,22,3,2,9954,9965,9,10098,10109,9,-1,-1,-1,9965,9968
846,3,3,20,6,10932,10938,10794,6,10,2,10811,10814,6,10955,10958,6,-1,-1,-1,10814,10824
845,8,8,38,3,11452,11469,11370,17,2,2,11400,11408,3,11498,11507,3,-1,-1,-1,11408,11410
844,2,2,15,46,1251,1255,1078,4,8,2,1091,1093,46,1268,1270,46,-1,-1,-1,1093,1102
843,1,1,21,22,6999,7002,6836,3,12,2,6856,6857,22,7021,7023,22,-1,-1,-1,6857,6870
842,9,9,45,30,5416,5437,5321,21,3,2,5357,5366,30,5470,5482,30,-1,-1,-1,5366,5369
841,10,10,20,2,11659,11681,11546,22,3,2,11556,11566,2,11689,11701,2,-1,-1,-1,11566,11569
840,12,12,32,31,5154,5176,5039,22,2,2,5059,5071,31,5198,5208,31,-1,-1,-1,5071,5073
839,10,10,25,14,8826,8844,8684,18,2,2,8699,8709,14,8861,8869,14,-1,-1,-1,8709,8711
838,12,12,16,26,6173,6193,6134,20,2,2,6138,6150,26,6201,6209,26,-1,-1,-1,6150,6152
837,9,9,49,31,5187,5204,5064,17,3,2,5104,5113,31,5245,5253,31,-1,-1,-1,5113,5116
836,8,8,4,16,8415,8431,8360,16,1,2,8356,8364,16,8427,8435,16,-1,-1,-1,8364,8365
835,2,2,42,5,11127,11130,11040,3,12,2,11080,11082,5,11171,11172,5,-1,-1,-1,11082,11095
834,2,2,33,23,6771,6775,6674,4,12,2,6705,6707,23,6806,6808,23,-1,-1,-1,6707,6720
833,12,12,24,17,8216,8240,8078,24,2,2,8090,8102,17,8252,8264,17,-1,-1,-1,8102,8104
832,8,8,2,6,10861,10878,10734,17,3,2,10728,10736,6,10871,10880,6,-1,-1,-1,10736,10739
831,2,2,40,45,1504,1509,1412,5,8,2,1450,1452,45,1546,1549,45,-1,-1,-1,1452,1460
830,3,3,38,23,6770,6774,6678,4,8,2,6713,6716,23,6811,6812,23,-1,-1,-1,6716,6725
829,3,3,26,23,6763,6769,6665,6,10,2,6688,6691,23,6792,6795,23,-1,-1,-1,6691,6702
828,2,2,50,15,8571,8574,8518,3,9,2,8566,8568,15,8623,8624,15,-1,-1,-1,8568,8577
827,11,11,14,24,6521,6540,6414,19,2,2,6417,6428,24,6546,6554,24,-1,-1,-1,6428,6430
826,12,12,3,46,1218,1241,1065,23,2,2,1056,1068,46,1233,1244,46,-1,-1,-1,1068,1070
825,8,8,26,32,4834,4850,4719,16,1,2,4737,4745,32,4868,4876,32,-1,-1,-1,4745,4746
824,11,11,17,5,11124,11146,11056,22,1,2,11062,11073,5,11152,11163,5,-1,-1,-1,11073,11074
823,9,9,31,32,4846,4863,4734,17,2,2,4756,4765,32,4886,4894,32,-1,-1,-1,4765,4767
822,1,1,15,5,11134,11137,11047,3,10,2,11061,11062,5,11150,11152,5,-1,-1,-1,11062,11073
821,9,9,29,14,8851,8868,8709,17,2,2,8729,8738,14,8889,8897,14,-1,-1,-1,8738,8740
820,3,3,21,47,898,904,739,6,8,2,757,760,47,922,925,47,-1,-1,-1,760,770
819,3,3,11,21,7310,7314,7153,4,11,2,7161,7164,21,7324,7325,21,-1,-1,-1,7164,7175
818,1,1,48,9,10142,10144,10012,2,11,2,10059,10060,9,10191,10192,9,-1,-1,-1,10060,10072
817,9,9,34,3,11434,11454,11354,20,2,2,11379,11388,3,11477,11488,3,-1,-1,-1,11388,11390
816,12,12,10,21,7282,7302,7151,20,3,2,7149,7161,21,7304,7312,21,-1,-1,-1,7161,7164
815,9,9,6,36,3840,3860,3755,20,1,2,3752,3761,36,3855,3866,36,-1,-1,-1,3761,3762
814,2,2,12,45,1505,1508,1408,3,8,2,1418,1420,45,1519,1520,45,-1,-1,-1,1420,1429
813,11,11,20,46,1265,1285,1110,20,1,2,1119,1130,46,1296,1305,46,-1,-1,-1,1130,1131
812,2,2,25,6,10945,10950,10808,5,12,2,10831,10833,6,10972,10975,6,-1,-1,-1,10833,10846
811,11,11,37,40,2782,2804,2643,22,2,2,2669,2680,40,2830,2841,40,-1,-1,-1,2680,2682
810,8,8,36,6,10940,10957,10817,17,2,2,10845,10853,6,10984,10993,6,-1,-1,-1,10853,10855
809,10,10,48,2,11721,11739,11602,18,3,2,11640,11650,2,11779,11787,2,-1,-1,-1,11650,11653
808,2,2,24,26,6194,6197,6136,3,10,2,6158,6160,26,6220,6221,26,-1,-1,-1,6160,6170
807,3,3,34,22,7044,7048,6895,4,8,2,6926,6929,22,7081,7082,22,-1,-1,-1,6929,6938
806,10,10,46,35,4134,4152,4021,18,1,2,4057,4067,35,4190,4198,35,-1,-1,-1,4067,4069
805,1,1,42,27,6068,6071,5899,3,11,2,5940,5941,27,6111,6113,27,-1,-1,-1,5941,5953
804,10,10,5,10,9787,9808,9684,21,1,2,9679,9689,10,9802,9813,10,-1,-1,-1,9689,9690
803,1,1,5,8,10345,10349,10234,4,8,2,10238,10239,8,10351,10354,8,-1,-1,-1,10239,10248
802,1,1,27,39,3154,3158,2985,4,10,2,3011,3012,39,3182,3185,39,-1,-1,-1,3012,3022
801,11,11,31,14,8855,8878,8718,23,1,2,8738,8749,14,8897,8909,14,-1,-1,-1,8749,8750
800,3,3,37,39,3169,3173,3005,4,12,2,3039,3042,39,3209,3210,39,-1,-1,-1,3042,3055
799,1,1,8,15,8570,8572,8501,2,8,2,8508,8509,15,8579,8580,15,-1,-1,-1,8509,8517
798,9,9,5,38,3348,3366,3236,18,1,2,3232,3241,38,3362,3371,38,-1,-1,-1,3241,3242
797,1,1,46,13,9157,9161,9033,4,9,2,9078,9079,13,9204,9207,13,-1,-1,-1,9079,9088
796,11,11,36,40,2774,2794,2633,20,1,2,2658,2669,40,2821,2830,40,-1,-1,-1,2669,2671
795,3,3,17,43,1983,1987,1821,4,8,2,1835,1838,43,2003,2004,43,-1,-1,-1,1838,1847
794,11,11,38,34,4385,4406,4266,21,2,2,4293,4304,34,4434,4444,34,-1,-1,-1,4304,4306
793,2,2,29,7,10629,10632,10488,3,12,2,10515,10517,7,10660,10661,7,-1,-1,-1,10517,10530
792,10,10,30,22,7020,7041,6882,21,2,2,6902,6912,22,7060,7071,22,-1,-1,-1,6912,6914
791,12,12,3,37,3593,3613,3490,20,3,2,3481,3493,37,3608,3616,37,-1,-1,-1,3493,3496
790,11,11,13,49,323,346,216,23,1,2,218,229,49,347,359,49,-1,-1,-1,229,230
789,2,2,49,24,6586,6590,6464,4,11,2,6511,6513,24,6637,6639,24,-1,-1,-1,6513,6525
788,12,12,13,39,3058,3081,2903,23,2,2,2904,2916,39,3083,3094,39,-1,-1,-1,2916,2918
787,2,2,45,24,6564,6569,6450,5,9,2,6493,6495,24,6611,6614,24,-1,-1,-1,6495,6505
786,1,1,16,11,9619,9622,9509,3,10,2,9524,9525,11,9636,9638,11,-1,-1,-1,9525,9536
785,10,10,32,8,10369,10389,10275,20,3,2,10297,10307,8,10411,10421,8,-1,-1,-1,10307,10310
784,1,1,32,28,5757,5761,5714,4,8,2,5745,5746,28,5790,5793,28,-1,-1,-1,5746,5755
783,1,1,44,7,10667,10671,10535,4,9,2,10578,10579,7,10712,10715,7,-1,-1,-1,10579,10589
782,12,12,9,17,8178,8201,8035,23,3,2,8032,8044,17,8199,8210,17,-1,-1,-1,8044,8047
781,3,3,32,41,2474,2479,2378,5,11,2,2407,2410,41,2509,2511,41,-1,-1,-1,2410,2422
780,10,10,27,11,9603,9625,9522,22,1,2,9539,9549,11,9640,9652,11,-1,-1,-1,9549,9550
779,8,8,21,12,9366,9383,9250,17,3,2,9263,9271,12,9395,9404,12,-1,-1,-1,9271,9274
778,11,11,35,30,5403,5425,5310,22,1,2,5334,5345,30,5449,5460,30,-1,-1,-1,5345,5346
777,8,8,24,22,6979,6995,6842,16,1,2,6858,6866,22,7011,7019,22,-1,-1,-1,6866,6867
776,8,8,13,42,2238,2257,2149,19,3,2,2154,2162,42,2259,2270,42,-1,-1,-1,2162,2166
775,9,9,1,40,2697,2717,2550,20,3,2,2542,2551,40,2707,2718,40,-1,-1,-1,2551,2554
774,1,1,13,42,2243,2246,2141,3,10,2,2153,2154,42,2257,2259,42,-1,-1,-1,2154,2164
773,11,11,33,49,362,382,250,20,2,2,272,283,49,406,415,49,-1,-1,-1,283,285
772,2,2,22,50,97,102,12,5,12,2,32,34,50,121,124,50,-1,-1,-1,34,47
771,2,2,30,18,7930,7933,7806,3,10,2,7834,7836,18,7962,7963,18,-1,-1,-1,7836,7847
770,3,3,44,35,4137,4143,4011,6,11,2,4052,4055,35,4184,4187,35,-1,-1,-1,4055,4066
769,2,2,7,7,10587,10591,10443,4,12,2,10448,10450,7,10596,10598,7,-1,-1,-1,10450,10463
768,1,1,20,37,3632,3636,3513,4,12,2,3532,3533,37,3653,3656,37,-1,-1,-1,3533,3546
767,3,3,18,9,10095,10099,9952,4,12,2,9967,9970,9,10116,10117,9,-1,-1,-1,9970,9984
766,3,3,34,7,10636,10641,10499,5,8,2,10530,10533,7,10673,10675,7,-1,-1,-1,10533,10541
765,11,11,45,46,1310,1333,1165,23,3,2,1199,1210,46,1366,1378,46,-1,-1,-1,1210,1213
764,9,9,25,34,4341,4361,4226,20,2,2,4242,4251,34,4375,4386,34,-1,-1,-1,4251,4253
763,9,9,5,47,871,890,728,19,1,2,724,733,47,885,895,47,-1,-1,-1,733,734
762,12,12,50,17,8282,8306,8139,24,1,2,8177,8189,17,8344,8356,17,-1,-1,-1,8189,8190
761,2,2,41,24,6566,6570,6452,4,8,2,6491,6493,24,6609,6611,24,-1,-1,-1,6493,6502
760,10,10,21,31,5134,5154,5010,20,2,2,5021,5031,31,5165,5175,31,-1,-1,-1,5031,5033
759,2,2,25,36,3902,3905,3789,3,12,2,3812,3814,36,3929,3930,36,-1,-1,-1,3814,3826
758,11,11,32,13,9131,9152,9023,21,3,2,9044,9055,13,9174,9184,13,-1,-1,-1,9055,9058
757,3,3,4,11,9589,9593,9490,4,8,2,9491,9494,11,9596,9597,11,-1,-1,-1,9494,9502
756,8,8,22,27,5990,6009,5848,19,3,2,5862,5870,27,6020,6031,27,-1,-1,-1,5870,5873
755,2,2,43,28,5748,5751,5708,3,8,2,5749,5751,28,5793,5794,28,-1,-1,-1,5751,5759
754,8,8,10,39,3040,3059,2883,19,3,2,2885,2893,39,3058,3069,39,-1,-1,-1,2893,2897
753,3,3,43,49,391,397,269,6,8,2,309,312,49,437,440,49,-1,-1,-1,312,320
752,2,2,42,44,1757,1760,1649,3,8,2,1689,1691,44,1801,1802,44,-1,-1,-1,1691,1700
751,10,10,26,38,3364,3386,3254,22,3,2,3270,3280,38,3400,3412,38,-1,-1,-1,3280,3283
750,9,9,34,3,11421,11438,11345,17,1,2,11370,11379,3,11464,11472,3,-1,-1,-1,11379,11380
749,1,1,24,27,6006,6009,5847,3,9,2,5870,5871,27,6031,6033,27,-1,-1,-1,5871,5881
748,12,12,29,2,11669,11690,11559,21,3,2,11576,11588,2,11710,11719,2,-1,-1,-1,11588,11591
747,10,10,43,14,8856,8876,8718,20,1,2,8751,8761,14,8909,8919,14,-1,-1,-1,8761,8762
746,3,3,14,7,10604,10610,10465,6,8,2,10476,10479,7,10621,10624,7,-1,-1,-1,10479,10487
745,2,2,27,48,656,659,529,3,9,2,554,556,48,685,686,48,-1,-1,-1,556,566
744,8,8,47,27,6058,6078,5903,20,3,2,5942,5950,27,6113,6125,27,-1,-1,-1,5950,5953
743,1,1,26,16,8427,8429,8362,2,12,2,8387,8388,16,8454,8455,16,-1,-1,-1,8388,8401
742,8,8,6,36,3833,3849,3746,16,1,2,3744,3752,36,3847,3855,36,-1,-1,-1,3752,3753
741,8,8,5,5,11101,11120,11031,19,3,2,11028,11036,5,11114,11125,5,-1,-1,-1,11036,11039
740,2,2,3,8,10334,10339,10226,5,10,2,10227,10229,8,10339,10342,8,-1,-1,-1,10229,10239
739,10,10,40,32,4879,4901,4764,22,3,2,4794,4804,32,4929,4941,32,-1,-1,-1,4804,4807
738,1,1,16,10,9812,9814,9692,2,12,2,9707,9708,10,9829,9830,10,-1,-1,-1,9708,9721
737,1,1,26,29,5609,5613,5508,4,8,2,5533,5534,29,5636,5639,29,-1,-1,-1,5534,5542
736,3,3,33,22,7044,7048,6893,4,11,2,6923,6926,22,7080,7081,22,-1,-1,-1,6926,6937
735,2,2,12,12,9338,9343,9203,5,12,2,9213,9215,12,9352,9355,12,-1,-1,-1,9215,9228
734,3,3,34,20,7558,7562,7457,4,9,2,7488,7491,20,7595,7596,20,-1,-1,-1,7491,7500
733,10,10,42,37,3659,3678,3554,19,1,2,3586,3596,37,3711,3720,37,-1,-1,-1,3596,3597
732,1,1,26,37,3639,3643,3520,4,10,2,3545,3546,37,3666,3669,37,-1,-1,-1,3546,3557
731,12,12,25,31,5146,5167,5028,21,3,2,5041,5053,31,5183,5192,31,-1,-1,-1,5053,5056
730,3,3,40,22,7053,7058,6909,5,12,2,6946,6949,22,7096,7098,22,-1,-1,-1,6949,6962
729,2,2,27,39,3164,3167,2984,3,12,2,3009,3011,39,3193,3194,39,-1,-1,-1,3011,3024
728,3,3,21,41,2457,2462,2360,5,8,2,2378,2381,41,2481,2483,41,-1,-1,-1,2381,2389
727,12,12,19,40,2766,2787,2625,21,3,2,2632,2644,40,2797,2806,40,-1,-1,-1,2644,2647
726,1,1,32,3,11442,11445,11338,3,11,2,11369,11370,3,11475,11477,3,-1,-1,-1,11370,11382
725,11,11,2,14,8777,8799,8636,22,3,2,8627,8638,14,8790,8801,14,-1,-1,-1,8638,8641
724,3,3,21,38,3374,3379,3248,5,11,2,3266,3269,38,3398,3400,38,-1,-1,-1,3269,3280
723,3,3,20,17,8214,8220,8061,6,8,2,8078,8081,17,8237,8240,17,-1,-1,-1,8081,8089
722,1,1,31,5,11134,11138,11046,4,11,2,11076,11077,5,11166,11169,5,-1,-1,-1,11077,11089
721,1,1,20,44,1719,1722,1603,3,12,2,1622,1623,44,1740,1742,44,-1,-1,-1,1623,1636
720,10,10,41,43,2031,2053,1896,22,1,2,1927,1937,43,2082,2094,43,-1,-1,-1,1937,1938
719,12,12,26,9,10107,10127,9990,20,3,2,10004,10016,9,10145,10153,9,-1,-1,-1,10016,10019
718,2,2,29,31,5164,5168,5026,4,10,2,5053,5055,31,5195,5197,31,-1,-1,-1,5055,5066
717,9,9,27,41,2449,2466,2368,17,2,2,2386,2395,41,2485,2493,41,-1,-1,-1,2395,2397
716,2,2,24,48,645,650,518,5,11,2,540,542,48,671,674,48,-1,-1,-1,542,555
715,10,10,12,13,9104,9123,8996,19,3,2,8998,9008,13,9126,9135,13,-1,-1,-1,9008,9011
714,1,1,31,27,6036,6040,5865,4,12,2,5895,5896,27,6068,6071,27,-1,-1,-1,5896,5909
713,3,3,24,40,2779,2784,2623,5,10,2,2644,2647,40,2806,2808,40,-1,-1,-1,2647,2657
712,10,10,31,36,3876,3898,3793,22,1,2,3814,3824,36,3917,3929,36,-1,-1,-1,3824,3825
711,11,11,3,40,2715,2738,2572,23,2,2,2564,2575,40,2729,2741,40,-1,-1,-1,2575,2577
710,12,12,33,49,351,373,239,22,1,2,260,272,49,396,406,49,-1,-1,-1,272,273
709,3,3,22,19,7710,7715,7655,5,11,2,7674,7677,19,7735,7737,19,-1,-1,-1,7677,7688
708,9,9,15,2,11655,11674,11541,19,3,2,11547,11556,2,11679,11689,2,-1,-1,-1,11556,11560
707,11,11,29,21,7313,7336,7180,23,3,2,7198,7209,21,7353,7365,21,-1,-1,-1,7209,7212
706,2,2,45,7,10679,10683,10546,4,9,2,10589,10591,7,10726,10728,7,-1,-1,-1,10591,10600
705,11,11,19,48,610,633,508,23,1,2,516,527,48,640,652,48,-1,-1,-1,527,528
704,8,8,39,18,7949,7965,7835,16,3,2,7866,7874,18,7996,8004,18,-1,-1,-1,7874,7877
703,9,9,29,35,4100,4120,3987,20,1,2,4007,4016,35,4138,4149,35,-1,-1,-1,4016,4017
702,2,2,28,2,11679,11682,11548,3,10,2,11574,11576,2,11709,11710,2,-1,-1,-1,11576,11587
701,8,8,29,14,8843,8860,8700,17,3,2,8721,8729,14,8880,8889,14,-1,-1,-1,8729,8732
700,10,10,25,17,8229,8250,8088,21,2,2,8103,8113,17,8264,8275,17,-1,-1,-1,8113,8115
699,12,12,7,48,561,582,464,21,3,2,459,471,48,580,589,48,-1,-1,-1,471,474
698,1,1,20,50,95,98,12,3,10,2,31,32,50,116,118,50,-1,-1,-1,32,43
697,3,3,45,36,3890,3896,3788,6,12,2,3830,3833,36,3938,3941,36,-1,-1,-1,3833,3846
696,10,10,6,18,7879,7901,7769,22,2,2,7765,7775,18,7895,7907,18,-1,-1,-1,7775,7778
695,8,8,18,22,6975,6993,6838,18,3,2,6848,6856,22,7001,7011,22,-1,-1,-1,6856,6859
694,8,8,8,40,2725,2743,2578,18,1,2,2578,2586,40,2741,2751,40,-1,-1,-1,2586,2587
693,8,8,15,4,11256,11273,11208,17,3,2,11215,11223,4,11279,11288,4,-1,-1,-1,11223,11226
692,3,3,9,7,10596,10602,10457,6,11,2,10463,10466,7,10608,10611,7,-1,-1,-1,10466,10477
691,3,3,43,36,3888,3893,3787,5,10,2,3827,3830,36,3934,3936,36,-1,-1,-1,3830,3841
690,11,11,3,40,2706,2726,2561,20,1,2,2553,2564,40,2720,2729,40,-1,-1,-1,2564,2565
689,3,3,28,44,1746,1752,1633,6,12,2,1658,1661,44,1777,1780,44,-1,-1,-1,1661,1673
688,9,9,15,11,9583,9602,9499,19,3,2,9505,9514,11,9607,9617,11,-1,-1,-1,9514,9517
687,2,2,7,15,8571,8576,8501,5,11,2,8506,8508,15,8580,8583,15,-1,-1,-1,8508,8520
686,3,3,19,46,1271,1277,1100,6,9,2,1116,1119,46,1293,1296,46,-1,-1,-1,1119,1128
685,1,1,18,37,3632,3635,3514,3,11,2,3531,3532,37,3651,3653,37,-1,-1,-1,3532,3544
684,12,12,39,43,2020,2043,1888,23,1,2,1915,1927,43,2071,2082,43,-1,-1,-1,1927,1929
683,2,2,30,48,654,659,528,5,9,2,556,558,48,686,689,48,-1,-1,-1,558,568
682,2,2,16,29,5617,5620,5513,3,12,2,5527,5529,29,5635,5636,29,-1,-1,-1,5529,5542
681,2,2,5,7,10588,10591,10443,3,11,2,10446,10448,7,10595,10596,7,-1,-1,-1,10448,10460
680,2,2,50,1,11871,11875,11813,4,10,2,11861,11863,1,11923,11925,1,-1,-1,-1,11863,11873
679,1,1,40,47,971,975,803,4,11,2,842,843,47,1012,1015,47,-1,-1,-1,843,854
678,3,3,27,7,10617,10621,10478,4,11,2,10502,10505,7,10647,10648,7,-1,-1,-1,10505,10518
677,12,12,38,49,375,398,267,23,2,2,293,305,49,425,436,49,-1,-1,-1,305,307
676,12,12,44,49,387,407,280,20,2,2,312,324,49,443,451,49,-1,-1,-1,324,326
675,3,3,46,46,1331,1337,1169,6,11,2,1212,1215,46,1380,1383,46,-1,-1,-1,1215,1227
674,3,3,5,38,3350,3354,3227,4,8,2,3229,3232,38,3358,3359,38,-1,-1,-1,3232,3240
673,3,3,46,2,11720,11725,11584,5,11,2,11627,11630,2,11769,11771,2,-1,-1,-1,11630,11642
672,11,11,17,31,5129,5148,5004,19,2,2,5010,5021,31,5157,5165,31,-1,-1,-1,5021,5023
671,2,2,39,41,2478,2483,2386,5,10,2,2423,2425,41,2519,2522,41,-1,-1,-1,2425,2435
670,2,2,1,44,1691,1694,1582,3,11,2,1581,1583,44,1694,1695,44,-1,-1,-1,1583,1594
669,8,8,29,44,1732,1748,1640,16,3,2,1661,1669,44,1769,1777,44,-1,-1,-1,1669,1672
668,2,2,1,13,9078,9083,8955,5,11,2,8954,8956,13,9081,9084,13,-1,-1,-1,8956,8968
667,9,9,32,27,6030,6048,5882,18,2,2,5905,5914,27,6071,6080,27,-1,-1,-1,5914,5916
666,1,1,21,3,11421,11424,11321,3,9,2,11341,11342,3,11443,11445,3,-1,-1,-1,11342,11351
665,1,1,17,47,903,905,738,2,12,2,754,755,47,921,922,47,-1,-1,-1,755,768
664,10,10,27,47,922,943,778,21,3,2,795,805,47,959,970,47,-1,-1,-1,805,808
663,3,3,14,33,4609,4613,4497,4,11,2,4508,4511,33,4626,4627,33,-1,-1,-1,4511,4523
662,9,9,34,32,4855,4876,4743,21,1,2,4768,4777,32,4898,4910,32,-1,-1,-1,4777,4778
661,1,1,34,35,4127,4129,3984,2,12,2,4017,4018,35,4162,4163,35,-1,-1,-1,4018,4031
660,2,2,7,37,3621,3625,3500,4,9,2,3505,3507,37,3630,3632,37,-1,-1,-1,3507,3517
659,12,12,39,38,3391,3413,3282,22,2,2,3309,3321,38,3442,3452,38,-1,-1,-1,3321,3323
658,1,1,20,30,5406,5409,5285,3,12,2,5304,5305,30,5427,5429,30,-1,-1,-1,5305,5318
657,10,10,2,15,8556,8575,8503,19,2,2,8495,8505,15,8568,8577,15,-1,-1,-1,8505,8507
656,3,3,38,16,8426,8432,8367,6,8,2,8402,8405,16,8467,8470,16,-1,-1,-1,8405,8414
655,12,12,46,1,11856,11877,11815,21,1,2,11849,11861,1,11914,11923,1,-1,-1,-1,11861,11862
654,3,3,44,38,3428,3432,3299,4,9,2,3340,3343,38,3475,3476,38,-1,-1,-1,3343,3353
653,9,9,2,33,4597,4614,4505,17,1,2,4498,4507,33,4608,4616,33,-1,-1,-1,4507,4508
652,2,2,7,29,5593,5596,5492,3,10,2,5497,5499,29,5602,5603,29,-1,-1,-1,5499,5510
651,10,10,6,17,8173,8193,8026,20,1,2,8022,8032,17,8189,8199,17,-1,-1,-1,8032,8033
650,8,8,7,27,5962,5979,5823,17,3,2,5822,5830,27,5977,5986,27,-1,-1,-1,5830,5833
649,12,12,36,29,5616,5638,5528,22,1,2,5552,5564,29,5664,5674,29,-1,-1,-1,5564,5565
648,2,2,4,38,3353,3358,3225,5,11,2,3227,3229,38,3359,3362,38,-1,-1,-1,3229,3241
647,9,9,6,31,5110,5128,4981,18,1,2,4978,4987,31,5125,5134,31,-1,-1,-1,4987,4988
646,8,8,41,44,1742,1758,1648,16,2,2,1681,1689,44,1791,1799,44,-1,-1,-1,1689,1691
645,10,10,11,29,5594,5613,5508,19,1,2,5509,5519,29,5615,5624,29,-1,-1,-1,5519,5520
644,12,12,39,7,10642,10664,10528,22,3,2,10555,10567,7,10693,10703,7,-1,-1,-1,10567,10570
643,2,2,36,43,2030,2033,1876,3,9,2,1910,1912,43,2068,2069,43,-1,-1,-1,1912,1922
642,10,10,47,14,8875,8894,8733,19,3,2,8770,8780,14,8932,8941,14,-1,-1,-1,8780,8783
641,1,1,46,14,8884,8886,8724,2,10,2,8769,8770,14,8931,8932,14,-1,-1,-1,8770,8780
640,12,12,43,20,7562,7586,7482,24,2,2,7513,7525,20,7617,7629,20,-1,-1,-1,7525,7527
639,12,12,7,10,9797,9820,9697,23,1,2,9692,9704,10,9816,9827,10,-1,-1,-1,9704,9705
638,12,12,1,33,4587,4607,4497,20,2,2,4486,4498,33,4600,4608,33,-1,-1,-1,4498,4500
637,12,12,45,5,11126,11147,11060,21,1,2,11093,11105,5,11183,11192,5,-1,-1,-1,11105,11106
636,1,1,46,2,11720,11723,11581,3,11,2,11626,11627,2,11767,11769,2,-1,-1,-1,11627,11639
635,10,10,47,2,11714,11732,11593,18,2,2,11630,11640,2,11771,11779,2,-1,-1,-1,11640,11643
634,1,1,18,13,9127,9131,8999,4,12,2,9016,9017,13,9146,9149,13,-1,-1,-1,9017,9029
633,10,10,44,17,8279,8300,8133,21,3,2,8167,8177,17,8333,8344,17,-1,-1,-1,8177,8180
632,1,1,11,38,3368,3371,3243,3,8,2,3253,3254,38,3380,3382,38,-1,-1,-1,3254,3262
631,1,1,32,40,2784,2788,2626,4,8,2,2657,2658,40,2817,2820,40,-1,-1,-1,2658,2666
630,10,10,4,27,5952,5973,5818,21,3,2,5812,5822,27,5966,5977,27,-1,-1,-1,5822,5825
629,1,1,33,32,4861,4865,4735,4,8,2,4767,4768,32,4895,4898,32,-1,-1,-1,4768,4777
628,1,1,40,30,5419,5421,5306,2,9,2,5345,5346,30,5460,5461,30,-1,-1,-1,5346,5355
627,2,2,29,27,6002,6007,5844,5,10,2,5871,5873,27,6033,6036,27,-1,-1,-1,5873,5884
626,1,1,49,8,10389,10393,10279,4,8,2,10327,10328,8,10439,10442,8,-1,-1,-1,10328,10336
625,10,10,13,21,7302,7324,7169,22,3,2,7172,7182,21,7325,7337,21,-1,-1,-1,7182,7185
624,1,1,14,18,7895,7899,7766,4,10,2,7779,7780,18,7910,7913,18,-1,-1,-1,7780,7790
623,2,2,10,48,599,603,481,4,10,2,489,491,48,611,613,48,-1,-1,-1,491,502
622,11,11,15,5,11115,11135,11046,20,2,2,11050,11061,5,11141,11150,5,-1,-1,-1,11061,11063
621,2,2,47,21,7380,7383,7231,3,12,2,7276,7278,21,7429,7430,21,-1,-1,-1,7278,7291
620,12,12,40,47,949,972,802,23,1,2,830,842,47,1001,1012,47,-1,-1,-1,842,843
619,9,9,43,37,3671,3689,3562,18,1,2,3596,3605,37,3723,3732,37,-1,-1,-1,3605,3606
618,10,10,28,38,3374,3396,3262,22,3,2,3280,3290,38,3412,3424,38,-1,-1,-1,3290,3293
617,8,8,12,45,1490,1506,1406,16,2,2,1410,1418,45,1510,1518,45,-1,-1,-1,1418,1420
616,9,9,32,27,6017,6036,5873,19,3,2,5896,5905,27,6058,6068,27,-1,-1,-1,5905,5908
615,3,3,22,41,2458,2463,2362,5,12,2,2381,2384,41,2483,2485,41,-1,-1,-1,2384,2397
614,12,12,8,6,10905,10928,10786,23,3,2,10782,10794,6,10925,10936,6,-1,-1,-1,10794,10797
613,8,8,47,12,9406,9425,9290,19,2,2,9329,9337,12,9461,9472,12,-1,-1,-1,9337,9339
612,3,3,11,40,2772,2776,2609,4,9,2,2617,2620,40,2786,2787,40,-1,-1,-1,2620,2629
611,3,3,25,43,2010,2014,1854,4,10,2,1876,1879,43,2038,2039,43,-1,-1,-1,1879,1889
610,9,9,3,11,9566,9585,9479,19,1,2,9473,9482,11,9578,9588,11,-1,-1,-1,9482,9483
609,1,1,47,10,9888,9890,9746,2,12,2,9792,9793,10,9936,9937,10,-1,-1,-1,9793,9806
608,9,9,49,10,9866,9887,9753,21,2,2,9793,9802,10,9924,9936,10,-1,-1,-1,9802,9804
607,3,3,12,35,4067,4071,3938,4,11,2,3947,3950,35,4082,4083,35,-1,-1,-1,3950,3962
606,2,2,7,45,1509,1512,1403,3,12,2,1408,1410,45,1518,1519,45,-1,-1,-1,1410,1422
605,2,2,10,48,598,601,479,3,11,2,487,489,48,610,611,48,-1,-1,-1,489,501
604,10,10,39,44,1731,1749,1641,18,2,2,1670,1680,44,1780,1788,44,-1,-1,-1,1680,1682
603,12,12,26,44,1720,1743,1632,23,3,2,1646,1658,44,1758,1769,44,-1,-1,-1,1658,1661
602,12,12,13,41,2440,2460,2355,20,1,2,2356,2368,41,2465,2473,41,-1,-1,-1,2368,2369
601,2,2,10,30,5400,5404,5271,4,11,2,5279,5281,30,5412,5414,30,-1,-1,-1,5281,5294
600,2,2,45,21,7376,7381,7231,5,12,2,7274,7276,21,7423,7426,21,-1,-1,-1,7276,7289
599,11,11,11,40,2753,2775,2606,22,3,2,2606,2617,40,2775,2786,40,-1,-1,-1,2617,2620
598,12,12,28,35,4085,4109,3977,24,3,2,3993,4005,35,4125,4137,35,-1,-1,-1,4005,4008
597,12,12,5,47,858,880,719,22,1,2,712,724,47,875,885,47,-1,-1,-1,724,725
596,9,9,32,1,11851,11869,11807,18,2,2,11830,11839,1,11892,11901,1,-1,-1,-1,11839,11841
595,11,11,47,22,7060,7083,6939,23,2,2,6975,6986,22,7118,7130,22,-1,-1,-1,6986,6988
594,11,11,30,32,4835,4856,4726,21,3,2,4745,4756,32,4876,4886,32,-1,-1,-1,4756,4759
593,10,10,49,16,8424,8445,8376,21,2,2,8415,8425,16,8483,8494,16,-1,-1,-1,8425,8427
592,2,2,30,6,10948,10951,10809,3,10,2,10837,10839,6,10980,10981,6,-1,-1,-1,10839,10850
591,1,1,37,10,9862,9865,9734,3,9,2,9770,9771,10,9900,9902,10,-1,-1,-1,9771,9780
590,8,8,6,48,554,574,453,20,3,2,451,459,48,568,580,48,-1,-1,-1,459,462
589,3,3,50,32,4915,4920,4783,5,12,2,4830,4833,32,4968,4970,32,-1,-1,-1,4833,4845
588,10,10,28,11,9615,9636,9531,21,3,2,9549,9559,11,9653,9664,11,-1,-1,-1,9559,9562
587,12,12,24,43,1984,2004,1843,20,3,2,1855,1867,43,2020,2028,43,-1,-1,-1,1867,1870
586,2,2,16,39,3078,3082,2904,4,10,2,2918,2920,39,3096,3098,39,-1,-1,-1,2920,2931
585,11,11,30,45,1484,1506,1405,22,2,2,1424,1435,45,1525,1536,45,-1,-1,-1,1435,1437
584,3,3,40,41,2479,2484,2388,5,10,2,2425,2428,41,2522,2524,41,-1,-1,-1,2428,2439
583,11,11,44,34,4399,4421,4283,22,2,2,4316,4327,34,4454,4465,34,-1,-1,-1,4327,4329
582,1,1,11,5,11127,11130,11039,3,11,2,11049,11050,5,11139,11141,5,-1,-1,-1,11050,11061
581,11,11,6,6,10894,10917,10775,23,1,2,10770,10781,6,10911,10923,6,-1,-1,-1,10781,10782
580,2,2,19,30,5404,5408,5285,4,12,2,5302,5304,30,5425,5427,30,-1,-1,-1,5304,5317
579,11,11,25,48,638,660,529,22,2,2,543,554,48,674,685,48,-1,-1,-1,554,557
578,2,2,50,16,8442,8445,8377,3,9,2,8425,8427,16,8494,8495,16,-1,-1,-1,8427,8436
577,3,3,41,13,9163,9168,9037,5,11,2,9075,9078,13,9207,9209,13,-1,-1,-1,9078,9090
576,10,10,27,26,6184,6202,6143,18,3,2,6160,6170,26,6221,6229,26,-1,-1,-1,6170,6173
575,1,1,49,25,6335,6338,6268,3,10,2,6316,6317,25,6385,6387,25,-1,-1,-1,6317,6328
574,1,1,36,46,1313,1315,1150,2,10,2,1185,1186,46,1350,1351,46,-1,-1,-1,1186,1197
573,3,3,25,8,10359,10364,10253,5,9,2,10275,10278,8,10387,10389,8,-1,-1,-1,10278,10287
572,1,1,2,11,9573,9576,9471,3,8,2,9472,9473,11,9576,9578,11,-1,-1,-1,9473,9481
571,1,1,29,45,1491,1493,1393,2,11,2,1421,1422,45,1521,1522,45,-1,-1,-1,1422,1434
570,11,11,8,27,5967,5988,5833,21,2,2,5830,5841,27,5986,5996,27,-1,-1,-1,5841,5843
569,12,12,31,39,3151,3174,3002,23,3,2,3021,3033,39,3194,3205,39,-1,-1,-1,3033,3036
568,3,3,35,46,1311,1315,1150,4,11,2,1182,1185,46,1349,1350,46,-1,-1,-1,1185,1196
567,2,2,40,6,10961,10964,10823,3,9,2,10861,10863,6,11003,11004,6,-1,-1,-1,10863,10872
566,12,12,37,35,4117,4137,4006,20,3,2,4031,4043,35,4166,4174,35,-1,-1,-1,4043,4046
565,1,1,31,21,7333,7335,7179,2,11,2,7209,7210,21,7365,7366,21,-1,-1,-1,7210,7222
564,2,2,4,29,5593,5598,5493,5,10,2,5495,5497,29,5599,5602,29,-1,-1,-1,5497,5507
563,9,9,10,48,579,600,477,21,3,2,478,487,48,598,610,48,-1,-1,-1,487,490
562,2,2,14,25,6340,6345,6277,5,8,2,6289,6291,25,6356,6359,25,-1,-1,-1,6291,6299
561,3,3,31,11,9630,9635,9531,5,9,2,9559,9562,11,9664,9666,11,-1,-1,-1,9562,9571
560,10,10,21,33,4587,4605,4500,18,1,2,4511,4521,33,4618,4626,33,-1,-1,-1,4521,4522
559,12,12,19,18,7884,7905,7773,21,3,2,7780,7792,18,7915,7924,18,-1,-1,-1,7792,7795
558,2,2,49,11,9627,9630,9527,3,9,2,9574,9576,11,9678,9679,11,-1,-1,-1,9576,9586
557,2,2,33,9,10118,10121,9985,3,8,2,10016,10018,9,10153,10154,9,-1,-1,-1,10018,10027
556,2,2,41,16,8427,8432,8366,5,8,2,8405,8407,16,8470,8473,16,-1,-1,-1,8407,8416
555,10,10,34,43,2016,2034,1876,18,3,2,1900,1910,43,2060,2068,43,-1,-1,-1,1910,1913
554,11,11,15,46,1231,1253,1076,22,3,2,1080,1091,46,1257,1268,46,-1,-1,-1,1091,1094
553,9,9,33,16,8414,8432,8366,18,3,2,8390,8399,16,8456,8465,16,-1,-1,-1,8399,8403
552,3,3,42,45,1525,1529,1434,4,10,2,1473,1476,45,1570,1571,45,-1,-1,-1,1476,1486
551,1,1,25,46,1280,1283,1108,3,11,2,1132,1133,46,1306,1308,46,-1,-1,-1,1133,1145
550,10,10,37,49,368,388,256,20,1,2,283,293,49,415,425,49,-1,-1,-1,293,294
549,12,12,24,32,4822,4844,4713,22,3,2,4725,4737,32,4858,4868,32,-1,-1,-1,4737,4740
548,3,3,36,27,6044,6050,5884,6,9,2,5917,5920,27,6083,6086,27,-1,-1,-1,5920,5930
547,8,8,41,29,5637,5657,5543,20,2,2,5576,5584,29,5686,5698,29,-1,-1,-1,5584,5587
546,3,3,15,2,11660,11664,11532,4,10,2,11544,11547,2,11678,11679,2,-1,-1,-1,11547,11558
545,12,12,30,27,5997,6020,5856,23,3,2,5874,5886,27,6039,6050,27,-1,-1,-1,5886,5889
544,8,8,11,29,5584,5602,5498,18,1,2,5501,5509,29,5603,5613,29,-1,-1,-1,5509,5510
543,12,12,19,42,2256,2276,2166,20,1,2,2173,2185,42,2287,2295,42,-1,-1,-1,2185,2186
542,12,12,32,42,2275,2299,2186,24,2,2,2206,2218,42,2319,2331,42,-1,-1,-1,2218,2220
541,3,3,10,43,1988,1993,1825,5,9,2,1832,1835,43,2001,2003,43,-1,-1,-1,1835,1844
540,10,10,45,7,10660,10681,10544,21,1,2,10579,10589,7,10715,10726,7,-1,-1,-1,10589,10590
539,12,12,7,20,7528,7551,7448,23,3,2,7443,7455,20,7547,7558,20,-1,-1,-1,7455,7458
538,11,11,20,14,8805,8828,8665,23,1,2,8674,8685,14,8836,8848,14,-1,-1,-1,8685,8686
537,11,11,6,20,7521,7541,7437,20,3,2,7432,7443,20,7538,7547,20,-1,-1,-1,7443,7446
536,3,3,40,45,1506,1510,1410,4,12,2,1447,1450,45,1549,1550,45,-1,-1,-1,1450,1462
535,1,1,10,47,896,898,732,2,10,2,741,742,47,907,908,47,-1,-1,-1,742,753
534,1,1,32,19,7704,7706,7646,2,10,2,7677,7678,19,7737,7738,19,-1,-1,-1,7678,7689
533,3,3,5,40,2743,2747,2573,4,12,2,2575,2578,40,2751,2752,40,-1,-1,-1,2578,2590
532,1,1,10,28,5744,5746,5701,2,8,2,5710,5711,28,5755,5756,28,-1,-1,-1,5711,5719
531,12,12,21,24,6539,6559,6435,20,3,2,6444,6456,24,6572,6580,24,-1,-1,-1,6456,6459
530,3,3,21,48,628,633,509,5,11,2,527,530,48,652,654,48,-1,-1,-1,530,541
529,10,10,29,12,9375,9395,9266,20,2,2,9285,9295,12,9414,9424,12,-1,-1,-1,9295,9297
528,10,10,17,28,5739,5760,5714,21,1,2,5721,5731,28,5766,5777,28,-1,-1,-1,5731,5732
527,8,8,6,47,881,901,735,20,3,2,733,741,47,895,907,47,-1,-1,-1,741,744
526,8,8,34,21,7328,7344,7189,16,1,2,7215,7223,21,7370,7378,21,-1,-1,-1,7223,7225
525,12,12,15,24,6527,6551,6425,24,3,2,6428,6440,24,6554,6566,24,-1,-1,-1,6440,6443
524,2,2,30,24,6560,6563,6434,3,10,2,6462,6464,24,6592,6593,24,-1,-1,-1,6464,6475
523,1,1,29,35,4119,4123,3978,4,11,2,4006,4007,35,4149,4152,35,-1,-1,-1,4007,4019
522,1,1,37,23,6770,6774,6676,4,10,2,6712,6713,23,6808,6811,23,-1,-1,-1,6713,6723
521,3,3,38,8,10380,10386,10272,6,10,2,10307,10310,8,10421,10424,8,-1,-1,-1,10310,10320
520,1,1,40,23,6772,6774,6677,2,11,2,6716,6717,23,6813,6814,23,-1,-1,-1,6717,6730
519,1,1,18,28,5760,5764,5717,4,9,2,5734,5735,28,5779,5782,28,-1,-1,-1,5735,5745
518,2,2,36,50,144,147,69,3,8,2,103,105,50,182,183,50,-1,-1,-1,105,114
517,8,8,35,47,938,954,787,16,2,2,814,822,47,981,989,47,-1,-1,-1,822,824
516,2,2,39,29,5642,5647,5537,5,8,2,5574,5576,29,5683,5686,29,-1,-1,-1,5576,5585
515,9,9,25,43,1994,2013,1851,19,2,2,1867,1876,43,2028,2038,43,-1,-1,-1,1876,1878
514,1,1,25,21,7320,7323,7170,3,10,2,7194,7195,21,7346,7348,21,-1,-1,-1,7195,7205
513,8,8,20,26,6181,6200,6138,19,1,2,6150,6158,26,6209,6220,26,-1,-1,-1,6158,6159
512,12,12,7,45,1479,1503,1401,24,2,2,1396,1408,45,1498,1510,45,-1,-1,-1,1408,1410
511,12,12,6,14,8783,8804,8644,21,1,2,8638,8650,14,8801,8810,14,-1,-1,-1,8650,8651
510,1,1,35,26,6208,6211,6148,3,10,2,6182,6183,26,6244,6246,26,-1,-1,-1,6183,6195
509,8,8,46,47,961,980,805,19,3,2,843,851,47,1015,1026,47,-1,-1,-1,851,855
508,1,1,48,45,1522,1525,1429,3,11,2,1476,1477,45,1571,1573,45,-1,-1,-1,1477,1489
507,11,11,30,23,6755,6775,6675,20,3,2,6694,6705,23,6796,6805,23,-1,-1,-1,6705,6708
506,2,2,14,30,5407,5410,5288,3,9,2,5300,5302,30,5423,5424,30,-1,-1,-1,5302,5312
505,9,9,31,39,3145,3162,2990,17,1,2,3012,3021,39,3185,3193,39,-1,-1,-1,3021,3023
504,1,1,19,25,6352,6355,6287,3,10,2,6305,6306,25,6372,6374,25,-1,-1,-1,6306,6316
503,8,8,18,20,7547,7564,7458,17,1,2,7468,7476,20,7573,7582,20,-1,-1,-1,7476,7477
502,12,12,6,42,2216,2236,2130,20,3,2,2124,2136,42,2234,2242,42,-1,-1,-1,2136,2139
501,9,9,16,23,6755,6774,6671,19,2,2,6678,6687,23,6780,6790,23,-1,-1,-1,6687,6689
500,9,9,22,35,4060,4079,3948,19,2,2,3961,3970,35,4091,4101,35,-1,-1,-1,3970,3972
499,12,12,39,7,10633,10654,10516,21,1,2,10543,10555,7,10684,10693,7,-1,-1,-1,10555,10556
498,2,2,14,2,11659,11664,11530,5,12,2,11542,11544,2,11675,11678,2,-1,-1,-1,11544,11557
497,2,2,21,8,10352,10355,10243,3,8,2,10262,10264,8,10375,10376,8,-1,-1,-1,10264,10273
496,1,1,46,27,6078,6080,5896,2,11,2,5941,5942,27,6125,6126,27,-1,-1,-1,5942,5954
495,1,1,8,24,6526,6530,6391,4,12,2,6398,6399,24,6535,6538,24,-1,-1,-1,6399,6412
494,10,10,6,23,6738,6758,6654,20,2,2,6650,6660,23,6754,6764,23,-1,-1,-1,6660,6662
493,8,8,4,30,5374,5391,5272,17,3,2,5268,5276,30,5386,5395,30,-1,-1,-1,5276,5279
492,12,12,33,30,5396,5416,5301,20,2,2,5322,5334,30,5441,5449,30,-1,-1,-1,5334,5336
491,1,1,16,6,10921,10925,10782,4,10,2,10797,10798,6,10938,10941,6,-1,-1,-1,10798,10808
490,3,3,38,37,3667,3673,3547,6,11,2,3582,3585,37,3708,3711,37,-1,-1,-1,3585,3597
489,8,8,48,33,4624,4640,4544,16,3,2,4584,4592,33,4680,4688,33,-1,-1,-1,4592,4597
488,2,2,17,4,11272,11276,11208,4,12,2,11223,11225,4,11291,11293,4,-1,-1,-1,11225,11238
487,10,10,47,30,5425,5447,5329,22,1,2,5366,5376,30,5482,5494,30,-1,-1,-1,5376,5377
486,10,10,11,7,10590,10610,10465,20,2,2,10466,10476,7,10611,10621,7,-1,-1,-1,10476,10479
485,2,2,28,35,4093,4097,3965,4,11,2,3991,3993,35,4123,4125,35,-1,-1,-1,3993,4004
484,12,12,33,45,1491,1513,1414,22,3,2,1435,1447,45,1536,1546,45,-1,-1,-1,1447,1450
483,1,1,12,42,2257,2261,2141,4,12,2,2152,2153,42,2270,2273,42,-1,-1,-1,2153,2167
482,1,1,6,39,3049,3052,2876,3,12,2,2881,2882,39,3056,3058,39,-1,-1,-1,2882,2894
481,3,3,19,21,7317,7323,7169,6,10,2,7185,7188,21,7339,7342,21,-1,-1,-1,7188,7199
480,12,12,15,48,588,612,489,24,1,2,492,504,48,615,627,48,-1,-1,-1,504,505
479,2,2,36,35,4125,4130,3995,5,11,2,4029,4031,35,4163,4166,35,-1,-1,-1,4031,4042
478,11,11,13,31,5122,5144,4997,22,1,2,4999,5010,31,5146,5157,31,-1,-1,-1,5010,5011
477,3,3,31,3,11438,11444,11338,6,12,2,11366,11369,3,11472,11475,3,-1,-1,-1,11369,11381
476,3,3,17,14,8802,8807,8648,5,10,2,8662,8665,14,8822,8824,14,-1,-1,-1,8665,8675
475,11,11,38,41,2462,2481,2385,19,1,2,2412,2423,41,2511,2519,41,-1,-1,-1,2423,2424
474,3,3,30,24,6549,6554,6432,5,10,2,6459,6462,24,6582,6584,24,-1,-1,-1,6462,6473
473,1,1,7,33,4608,4611,4501,3,12,2,4507,4508,33,4616,4618,33,-1,-1,-1,4508,4520
472,12,12,46,41,2476,2496,2406,20,1,2,2440,2452,41,2534,2542,41,-1,-1,-1,2452,2453
471,10,10,2,34,4336,4355,4219,19,1,2,4211,4221,34,4348,4357,34,-1,-1,-1,4221,4222
470,1,1,29,37,3649,3653,3529,4,12,2,3557,3558,37,3679,3682,37,-1,-1,-1,3558,3571
469,11,11,19,46,1252,1274,1097,22,1,2,1105,1116,46,1282,1293,46,-1,-1,-1,1116,1117
468,3,3,44,33,4631,4635,4540,4,9,2,4581,4584,33,4678,4679,33,-1,-1,-1,4584,4593
467,9,9,11,42,2226,2243,2141,17,2,2,2143,2152,42,2246,2254,42,-1,-1,-1,2152,2154
466,3,3,19,13,9139,9144,9010,5,12,2,9026,9029,13,9161,9163,13,-1,-1,-1,9029,9042
465,10,10,39,17,8262,8283,8117,21,1,2,8146,8156,17,8311,8322,17,-1,-1,-1,8156,8157
464,3,3,38,26,6205,6210,6148,5,11,2,6183,6186,26,6246,6248,26,-1,-1,-1,6186,6198
463,12,12,31,24,6550,6574,6454,24,2,2,6473,6485,24,6593,6605,24,-1,-1,-1,6485,6487
462,9,9,20,19,7697,7715,7654,18,2,2,7665,7674,19,7726,7735,19,-1,-1,-1,7674,7677
461,2,2,41,39,3165,3168,3003,3,10,2,3042,3044,39,3208,3209,39,-1,-1,-1,3044,3054
460,10,10,38,29,5626,5645,5536,19,3,2,5564,5574,29,5674,5683,29,-1,-1,-1,5574,5577
459,9,9,13,12,9317,9337,9211,20,1,2,9215,9224,12,9339,9350,12,-1,-1,-1,9224,9225
458,11,11,33,42,2287,2308,2196,21,3,2,2218,2229,42,2331,2341,42,-1,-1,-1,2229,2232
457,12,12,24,39,3107,3128,2957,21,2,2,2969,2981,39,3143,3152,39,-1,-1,-1,2981,2983
456,2,2,32,13,9138,9142,9012,4,10,2,9042,9044,13,9172,9174,13,-1,-1,-1,9044,9054
455,2,2,13,6,10926,10930,10784,4,11,2,10795,10797,6,10941,10943,6,-1,-1,-1,10797,10809
454,3,3,20,17,8217,8221,8058,4,12,2,8075,8078,17,8240,8241,17,-1,-1,-1,8078,8090
453,2,2,35,6,10956,10960,10810,4,11,2,10843,10845,6,10993,10995,6,-1,-1,-1,10845,10857
452,2,2,28,8,10372,10375,10253,3,12,2,10279,10281,8,10402,10403,8,-1,-1,-1,10281,10294
451,2,2,23,6,10945,10949,10808,4,9,2,10829,10831,6,10970,10972,6,-1,-1,-1,10831,10841
450,10,10,28,7,10610,10632,10487,22,3,2,10505,10515,7,10648,10660,7,-1,-1,-1,10515,10519
449,8,8,46,14,8868,8885,8723,17,1,2,8761,8769,14,8922,8931,14,-1,-1,-1,8769,8770
448,9,9,11,13,9091,9112,8987,21,2,2,8989,8998,13,9111,9123,13,-1,-1,-1,8998,9000
447,2,2,32,26,6207,6212,6141,5,12,2,6171,6173,26,6241,6244,26,-1,-1,-1,6173,6186
446,3,3,35,38,3386,3390,3259,4,8,2,3291,3294,38,3424,3425,38,-1,-1,-1,3294,3302
445,2,2,13,20,7552,7557,7454,5,8,2,7465,7467,20,7567,7570,20,-1,-1,-1,7467,7475
444,1,1,11,39,3057,3061,2883,4,10,2,2893,2894,39,3069,3072,39,-1,-1,-1,2894,2905
443,12,12,27,30,5390,5412,5292,22,3,2,5307,5319,30,5429,5439,30,-1,-1,-1,5319,5322
442,3,3,42,22,7053,7057,6910,4,11,2,6949,6952,22,7098,7099,22,-1,-1,-1,6952,6964
441,8,8,40,47,941,961,790,20,3,2,822,830,47,989,1001,47,-1,-1,-1,830,833
440,1,1,6,20,7528,7532,7426,4,10,2,7431,7432,20,7535,7538,20,-1,-1,-1,7432,7442
439,10,10,3,38,3333,3355,3224,22,2,2,3217,3227,38,3346,3358,38,-1,-1,-1,3227,3230
438,3,3,31,31,5163,5167,5028,4,9,2,5056,5059,31,5197,5198,31,-1,-1,-1,5059,5070
437,10,10,27,33,4600,4619,4516,19,2,2,4533,4543,33,4637,4646,33,-1,-1,-1,4543,4546
436,2,2,15,15,8567,8570,8497,3,9,2,8510,8512,15,8584,8585,15,-1,-1,-1,8512,8522
435,10,10,35,17,8254,8274,8109,20,1,2,8134,8144,17,8299,8309,17,-1,-1,-1,8144,8145
434,2,2,30,45,1490,1495,1394,5,10,2,1422,1424,45,1522,1525,45,-1,-1,-1,1424,1435
433,12,12,9,7,10577,10599,10454,22,3,2,10451,10463,7,10598,10608,7,-1,-1,-1,10463,10466
432,12,12,15,22,6962,6986,6833,24,1,2,6836,6848,22,6989,7001,22,-1,-1,-1,6848,6849
431,9,9,43,35,4122,4141,4009,19,3,2,4043,4052,35,4174,4184,35,-1,-1,-1,4052,4055
430,9,9,49,32,4899,4919,4781,20,1,2,4821,4830,32,4957,4968,32,-1,-1,-1,4830,4832
429,2,2,13,47,893,897,731,4,11,2,742,744,47,908,910,47,-1,-1,-1,744,756
428,10,10,9,49,342,363,6,21,2,3,11,15,49,231,237,49,361,372,49,237,240
427,2,2,29,4,11277,11282,11215,5,11,2,11242,11244,4,11308,11311,4,-1,-1,-1,11244,11256
426,12,12,41,34,4391,4413,4275,22,2,2,4304,4316,34,4444,4454,34,-1,-1,-1,4316,4318
425,11,11,39,18,7935,7957,7827,22,3,2,7855,7866,18,7985,7996,18,-1,-1,-1,7866,7869
424,9,9,19,44,1692,1712,1603,20,3,2,1613,1622,44,1720,1731,44,-1,-1,-1,1622,1626
423,11,11,31,43,1997,2019,1860,22,1,2,1880,1891,43,2039,2050,43,-1,-1,-1,1891,1892
422,11,11,8,4,11238,11259,11195,21,1,2,11192,11203,4,11257,11267,4,-1,-1,-1,11203,11204
421,9,9,34,26,6188,6207,6148,19,3,2,6173,6182,26,6231,6241,26,-1,-1,-1,6182,6185
420,11,11,26,22,7001,7024,6862,23,3,2,6877,6888,22,7038,7050,22,-1,-1,-1,6888,6891
419,1,1,4,12,9333,9335,9208,2,8,2,9211,9212,12,9338,9339,12,-1,-1,-1,9212,9221
418,1,1,15,9,10093,10097,9952,4,10,2,9966,9967,9,10109,10112,9,-1,-1,-1,9967,9977
417,8,8,45,2,11703,11722,11581,19,3,2,11618,11626,2,11756,11767,2,-1,-1,-1,11626,11630
416,2,2,22,12,9389,9392,9263,3,9,2,9283,9285,12,9413,9414,12,-1,-1,-1,9285,9294
415,11,11,47,22,7050,7071,6928,21,3,2,6964,6975,22,7108,7118,22,-1,-1,-1,6975,6978
414,2,2,28,18,7916,7919,7792,3,9,2,7818,7820,18,7946,7947,18,-1,-1,-1,7820,7831
413,3,3,42,43,2049,2054,1898,5,11,2,1937,1940,43,2094,2096,43,-1,-1,-1,1940,1951
412,1,1,15,42,2257,2261,2148,4,9,2,2162,2163,42,2273,2276,42,-1,-1,-1,2163,2174
411,3,3,23,17,8223,8229,8067,6,11,2,8087,8090,17,8249,8252,17,-1,-1,-1,8090,8102
410,12,12,15,25,6332,6354,6288,22,3,2,6291,6303,25,6359,6369,25,-1,-1,-1,6303,6306
409,8,8,41,50,134,153,72,19,1,2,105,113,50,183,194,50,-1,-1,-1,113,115
408,9,9,44,31,5164,5183,5042,19,3,2,5077,5086,31,5217,5227,31,-1,-1,-1,5086,5090
407,9,9,12,30,5393,5410,5286,17,3,2,5289,5298,30,5414,5422,30,-1,-1,-1,5298,5301
406,10,10,13,23,6741,6759,6657,18,1,2,6660,6670,23,6764,6772,23,-1,-1,-1,6670,6671
405,2,2,25,42,2280,2283,2170,3,11,2,2193,2195,42,2307,2308,42,-1,-1,-1,2195,2206
404,8,8,8,36,3861,3880,3769,19,2,2,3769,3777,36,3877,3888,36,-1,-1,-1,3777,3779
403,3,3,43,20,7570,7574,7470,4,8,2,7510,7513,20,7616,7617,20,-1,-1,-1,7513,7521
402,11,11,30,13,9122,9142,9012,20,1,2,9031,9042,13,9163,9172,13,-1,-1,-1,9042,9043
401,3,3,33,19,7702,7706,7648,4,9,2,7678,7681,19,7738,7739,19,-1,-1,-1,7681,7691
400,2,2,22,14,8834,8839,8677,5,8,2,8697,8699,14,8858,8861,14,-1,-1,-1,8699,8707
399,1,1,1,13,9077,9080,8953,3,11,2,8953,8954,13,9079,9081,13,-1,-1,-1,8954,8965
398,3,3,34,27,6043,6049,5883,6,9,2,5914,5917,27,6080,6083,27,-1,-1,-1,5917,5926
397,3,3,26,24,6551,6556,6433,5,11,2,6456,6459,24,6580,6582,24,-1,-1,-1,6459,6470
396,12,12,16,16,8408,8429,8363,21,1,2,8367,8379,16,8436,8445,16,-1,-1,-1,8379,8380
395,1,1,31,26,6197,6200,6140,3,12,2,6170,6171,26,6229,6231,26,-1,-1,-1,6171,6184
394,1,1,33,38,3391,3394,3258,3,11,2,3290,3291,38,3425,3427,38,-1,-1,-1,3291,3303
393,12,12,32,33,4602,4623,4523,21,2,2,4543,4555,33,4646,4655,33,-1,-1,-1,4555,4557
392,8,8,34,12,9383,9403,9275,20,1,2,9301,9309,12,9425,9437,12,-1,-1,-1,9309,9310
391,2,2,50,39,3161,3166,2997,5,11,2,3045,3047,39,3213,3216,39,-1,-1,-1,3047,3059
390,8,8,29,40,2771,2788,2626,17,2,2,2647,2655,40,2808,2817,40,-1,-1,-1,2655,2658
389,1,1,22,21,7319,7322,7169,3,8,2,7190,7191,21,7342,7344,21,-1,-1,-1,7191,7199
388,10,10,21,9,10095,10113,9972,18,1,2,9983,9993,9,10126,10134,9,-1,-1,-1,9993,9994
387,8,8,45,3,11458,11476,11378,18,2,2,11415,11423,3,11511,11521,3,-1,-1,-1,11423,11426
386,2,2,20,43,1982,1987,1820,5,10,2,1838,1840,43,2004,2007,43,-1,-1,-1,1840,1851
385,11,11,18,36,3862,3883,3772,21,3,2,3779,3790,36,3891,3901,36,-1,-1,-1,3790,3793
384,8,8,12,44,1690,1706,1599,16,2,2,1603,1611,44,1710,1718,44,-1,-1,-1,1611,1614
383,10,10,26,34,4351,4373,4235,22,2,2,4251,4261,34,4387,4399,34,-1,-1,-1,4261,4263
382,1,1,21,23,6768,6771,6667,3,8,2,6687,6688,23,6790,6792,23,-1,-1,-1,6688,6697
381,1,1,38,2,11711,11715,11577,4,10,2,11614,11615,2,11750,11753,2,-1,-1,-1,11615,11625
380,9,9,23,39,3091,3112,2935,21,3,2,2949,2958,39,3123,3135,39,-1,-1,-1,2958,2961
379,11,11,25,3,11419,11439,11341,20,2,2,11355,11366,3,11455,11464,3,-1,-1,-1,11366,11368
378,2,2,48,34,4427,4430,4291,3,10,2,4337,4339,34,4477,4478,34,-1,-1,-1,4339,4350
377,1,1,3,22,6984,6986,6833,2,11,2,6835,6836,22,6988,6989,22,-1,-1,-1,6836,6848
376,1,1,26,5,11138,11140,11050,2,11,2,11075,11076,5,11165,11166,5,-1,-1,-1,11076,11088
375,10,10,35,12,9393,9414,9284,21,2,2,9309,9319,12,9438,9449,12,-1,-1,-1,9319,9321
374,12,12,34,17,8242,8265,8100,23,2,2,8122,8134,17,8288,8299,17,-1,-1,-1,8134,8136
373,3,3,23,44,1727,1733,1622,6,8,2,1642,1645,44,1753,1756,44,-1,-1,-1,1645,1654
372,12,12,27,46,1281,1301,1130,20,2,2,1145,1157,46,1320,1328,46,-1,-1,-1,1157,1159
371,10,10,43,9,10109,10128,9995,19,2,2,10028,10038,9,10162,10171,9,-1,-1,-1,10038,10040
370,8,8,44,12,9398,9417,9285,19,3,2,9321,9329,12,9450,9461,12,-1,-1,-1,9329,9333
369,8,8,11,20,7539,7556,7452,17,3,2,7455,7463,20,7558,7567,20,-1,-1,-1,7463,7466
368,1,1,23,34,4362,4364,4219,2,11,2,4241,4242,34,4386,4387,34,-1,-1,-1,4242,4254
367,1,1,34,18,7924,7928,7803,4,9,2,7836,7837,18,7959,7962,18,-1,-1,-1,7837,7846
366,2,2,46,25,6335,6339,6270,4,9,2,6314,6316,25,6383,6385,25,-1,-1,-1,6316,6327
365,2,2,2,40,2714,2718,2551,4,9,2,2551,2553,40,2718,2720,40,-1,-1,-1,2553,2563
364,3,3,12,44,1693,1698,1591,5,8,2,1600,1603,44,1708,1710,44,-1,-1,-1,1603,1612
363,1,1,48,27,6077,6081,5903,4,8,2,5950,5951,27,6126,6129,27,-1,-1,-1,5951,5961
362,1,1,23,48,641,645,508,4,12,2,530,531,48,665,668,48,-1,-1,-1,531,544
361,8,8,4,6,10879,10895,10754,16,1,2,10750,10758,6,10891,10899,6,-1,-1,-1,10758,10759
360,11,11,3,8,10317,10336,10224,19,1,2,10216,10227,8,10331,10339,8,-1,-1,-1,10227,10228
359,2,2,6,13,9100,9105,8972,5,12,2,8976,8978,13,9108,9111,13,-1,-1,-1,8978,8991
358,3,3,7,10,9803,9809,9685,6,8,2,9689,9692,10,9813,9816,10,-1,-1,-1,9692,9700
357,12,12,21,43,1977,1999,1834,22,1,2,1843,1855,43,2010,2020,43,-1,-1,-1,1855,1856
356,3,3,22,39,3086,3090,2915,4,8,2,2934,2937,39,3111,3112,39,-1,-1,-1,2937,2945
355,12,12,48,35,4139,4163,4032,24,3,2,4068,4080,35,4199,4211,35,-1,-1,-1,4080,4083
354,2,2,25,2,11677,11682,11546,5,12,2,11569,11571,2,11704,11707,2,-1,-1,-1,11571,11584
353,11,11,27,35,4063,4086,3954,23,2,2,3970,3981,35,4101,4113,35,-1,-1,-1,3981,3983
352,12,12,22,39,3067,3089,2912,22,3,2,2922,2934,39,3101,3111,39,-1,-1,-1,2934,2937
351,3,3,20,25,6352,6358,6289,6,8,2,6306,6309,25,6375,6378,25,-1,-1,-1,6309,6319
350,2,2,22,37,3632,3635,3513,3,12,2,3533,3535,37,3656,3657,37,-1,-1,-1,3535,3548
349,8,8,18,48,602,621,498,19,1,2,508,516,48,628,639,48,-1,-1,-1,516,517
348,3,3,31,7,10627,10633,10489,6,10,2,10517,10520,7,10661,10664,7,-1,-1,-1,10520,10531
347,1,1,4,43,1973,1976,1810,3,10,2,1813,1814,43,1978,1980,43,-1,-1,-1,1814,1825
346,1,1,26,8,10373,10376,10253,3,12,2,10278,10279,8,10400,10402,8,-1,-1,-1,10279,10292
345,2,2,46,46,1330,1334,1166,4,8,2,1210,1212,46,1378,1380,46,-1,-1,-1,1212,1221
344,10,10,16,28,5730,5750,5705,20,3,2,5711,5721,28,5756,5766,28,-1,-1,-1,5721,5724
343,3,3,6,13,9089,9094,8970,5,10,2,8973,8976,13,9098,9100,13,-1,-1,-1,8976,8986
342,1,1,29,43,2020,2023,1851,3,12,2,1879,1880,43,2050,2052,43,-1,-1,-1,1880,1893
341,3,3,41,31,5170,5176,5036,6,10,2,5074,5077,31,5214,5217,31,-1,-1,-1,5077,5088
340,1,1,32,41,2470,2474,2375,4,11,2,2406,2407,41,2503,2506,41,-1,-1,-1,2407,2419
339,2,2,33,46,1304,1308,1138,4,9,2,1169,1171,46,1339,1341,46,-1,-1,-1,1171,1181
338,1,1,23,22,6995,6998,6835,3,10,2,6857,6858,22,7019,7021,22,-1,-1,-1,6858,6868
337,2,2,16,48,621,624,492,3,9,2,506,508,48,639,640,48,-1,-1,-1,508,518
336,12,12,6,6,10881,10905,10764,24,3,2,10758,10770,6,10899,10911,6,-1,-1,-1,10770,10773
335,9,9,27,34,4363,4380,4243,17,1,2,4261,4270,34,4399,4407,34,-1,-1,-1,4270,4271
334,1,1,33,44,1754,1758,1637,4,11,2,1669,1670,44,1788,1791,44,-1,-1,-1,1670,1683
333,3,3,34,12,9400,9404,9267,4,11,2,9298,9301,12,9437,9438,12,-1,-1,-1,9301,9313
332,9,9,4,36,3824,3843,3740,19,3,2,3735,3744,36,3837,3847,36,-1,-1,-1,3744,3748
331,2,2,49,18,7968,7973,7844,5,10,2,7891,7893,18,8019,8022,18,-1,-1,-1,7893,7904
330,8,8,15,29,5601,5620,5512,19,3,2,5519,5527,29,5624,5635,29,-1,-1,-1,5527,5530
329,2,2,28,18,7913,7916,7790,3,8,2,7816,7818,18,7943,7944,18,-1,-1,-1,7818,7826
328,2,2,21,21,7321,7325,7169,4,9,2,7188,7190,21,7344,7346,21,-1,-1,-1,7190,7200
327,1,1,45,43,2061,2064,1906,3,8,2,1950,1951,43,2107,2109,43,-1,-1,-1,1951,1959
326,9,9,10,25,6328,6346,6279,18,1,2,6280,6289,25,6347,6356,25,-1,-1,-1,6289,6290
325,10,10,11,3,11410,11432,11330,22,1,2,11331,11341,3,11431,11443,3,-1,-1,-1,11341,11342
324,2,2,30,29,5630,5634,5522,4,10,2,5550,5552,29,5662,5664,29,-1,-1,-1,5552,5562
323,9,9,45,31,5183,5200,5059,17,2,2,5095,5104,31,5237,5245,31,-1,-1,-1,5104,5106
322,9,9,12,26,6168,6189,6126,21,2,2,6129,6138,26,6189,6201,26,-1,-1,-1,6138,6140
321,3,3,49,21,7378,7382,7235,4,9,2,7281,7284,21,7430,7431,21,-1,-1,-1,7284,7295
320,9,9,44,18,7951,7970,7841,19,1,2,7876,7885,18,8004,8014,18,-1,-1,-1,7885,7886
319,1,1,11,18,7901,7904,7768,3,11,2,7778,7779,18,7913,7915,18,-1,-1,-1,7779,7791
318,12,12,42,45,1505,1528,1431,23,2,2,1461,1473,45,1559,1570,45,-1,-1,-1,1473,1475
317,10,10,11,40,2742,2764,2595,22,3,2,2596,2606,40,2763,2775,40,-1,-1,-1,2606,2609
316,1,1,39,38,3401,3403,3270,2,10,2,3308,3309,38,3441,3442,38,-1,-1,-1,3309,3320
315,11,11,24,8,10341,10363,10251,22,3,2,10264,10275,8,10376,10387,8,-1,-1,-1,10275,10278
314,10,10,22,14,8818,8836,8675,18,1,2,8687,8697,14,8850,8858,14,-1,-1,-1,8697,8698
313,8,8,21,12,9354,9374,9242,20,3,2,9255,9263,12,9383,9395,12,-1,-1,-1,9263,9266
312,8,8,45,6,10951,10971,10826,20,1,2,10863,10871,6,11004,11016,6,-1,-1,-1,10871,10873
311,1,1,47,35,4150,4152,4021,2,10,2,4067,4068,35,4198,4199,35,-1,-1,-1,4068,4079
310,3,3,43,28,5748,5752,5706,4,12,2,5746,5749,28,5794,5795,28,-1,-1,-1,5749,5762
309,10,10,9,43,1971,1992,1823,21,2,2,1822,1832,43,1990,2001,43,-1,-1,-1,1832,1834
308,2,2,13,44,1703,1707,1600,4,9,2,1611,1613,44,1718,1720,44,-1,-1,-1,1613,1623
307,9,9,5,9,10076,10093,9949,17,3,2,9945,9954,9,10090,10098,9,-1,-1,-1,9954,9957
306,10,10,43,38,3408,3429,3296,21,2,2,3329,3339,38,3461,3472,38,-1,-1,-1,3339,3341
305,11,11,44,17,8267,8289,8123,22,1,2,8156,8167,17,8322,8333,17,-1,-1,-1,8167,8168
304,12,12,24,47,899,923,761,24,3,2,773,785,47,935,947,47,-1,-1,-1,785,788
303,1,1,11,10,9815,9817,9694,2,9,2,9704,9705,10,9827,9828,10,-1,-1,-1,9705,9714
302,1,1,18,25,6355,6357,6287,2,11,2,6304,6305,25,6374,6375,25,-1,-1,-1,6305,6317
301,1,1,10,13,9112,9116,8979,4,10,2,8988,8989,13,9123,9126,13,-1,-1,-1,8989,9001
300,3,3,11,38,3368,3372,3242,4,10,2,3250,3253,38,3382,3383,38,-1,-1,-1,3253,3263
299,10,10,12,27,5974,5994,5839,20,2,2,5841,5851,27,5996,6006,27,-1,-1,-1,5851,5853
298,1,1,29,25,6350,6354,6283,4,12,2,6311,6312,25,6380,6383,25,-1,-1,-1,6312,6325
297,12,12,1,30,5365,5385,5264,20,2,2,5253,5265,30,5378,5386,30,-1,-1,-1,5265,5267
296,12,12,21,6,10925,10948,10805,23,2,2,10814,10826,6,10958,10969,6,-1,-1,-1,10826,10828
295,8,8,17,13,9110,9129,8999,19,1,2,9008,9016,13,9135,9146,13,-1,-1,-1,9016,9017
294,11,11,22,9,10101,10123,9982,22,3,2,9993,10004,9,10134,10145,9,-1,-1,-1,10004,10007
293,10,10,50,45,1513,1531,1437,18,3,2,1477,1487,45,1573,1581,45,-1,-1,-1,1487,1491
292,1,1,35,11,9630,9632,9528,2,12,2,9562,9563,11,9666,9667,11,-1,-1,-1,9563,9576
291,1,1,4,45,1482,1485,1380,3,9,2,1383,1384,45,1487,1489,45,-1,-1,-1,1384,1393
290,3,3,17,21,7317,7322,7168,5,8,2,7182,7185,21,7337,7339,21,-1,-1,-1,7185,7193
289,3,3,1,32,4829,4835,4700,6,10,2,4698,4701,32,4833,4836,32,-1,-1,-1,4701,4711
288,3,3,47,40,2817,2823,2657,6,10,2,2701,2704,40,2867,2870,40,-1,-1,-1,2704,2714
287,1,1,6,1,11859,11861,11786,2,8,2,11791,11792,1,11866,11867,1,-1,-1,-1,11792,11801
286,2,2,42,50,150,154,74,4,9,2,114,116,50,194,196,50,-1,-1,-1,116,125
285,3,3,36,50,141,146,67,5,8,2,100,103,50,180,182,50,-1,-1,-1,103,111
284,12,12,9,34,4336,4356,4224,20,3,2,4221,4233,34,4357,4365,34,-1,-1,-1,4233,4236
283,8,8,36,13,9140,9157,9027,17,1,2,9055,9063,13,9184,9193,13,-1,-1,-1,9063,9064
282,1,1,37,36,3892,3894,3788,2,9,2,3824,3825,36,3930,3931,36,-1,-1,-1,3825,3835
281,3,3,29,30,5407,5412,5293,5,9,2,5319,5322,30,5439,5441,30,-1,-1,-1,5322,5331
280,3,3,28,4,11264,11270,11204,6,10,2,11229,11232,4,11295,11298,4,-1,-1,-1,11232,11243
279,2,2,14,39,3078,3082,2904,4,12,2,2916,2918,39,3094,3096,39,-1,-1,-1,2918,2930
278,10,10,10,24,6503,6525,6399,22,2,2,6399,6409,24,6523,6535,24,-1,-1,-1,6409,6411
277,9,9,35,34,4377,4397,4255,20,2,2,4281,4290,34,4421,4432,34,-1,-1,-1,4290,4292
276,8,8,21,27,5980,5999,5841,19,3,2,5854,5862,27,6009,6020,27,-1,-1,-1,5862,5866
275,1,1,11,6,10924,10927,10784,3,9,2,10794,10795,6,10936,10938,6,-1,-1,-1,10795,10805
274,1,1,25,38,3369,3373,3245,4,8,2,3269,3270,38,3395,3398,38,-1,-1,-1,3270,3278
273,8,8,5,31,5100,5120,4973,20,3,2,4970,4978,31,5113,5125,31,-1,-1,-1,4978,4981
272,3,3,34,23,6768,6772,6676,4,8,2,6707,6710,23,6805,6806,23,-1,-1,-1,6710,6718
271,8,8,33,10,9828,9844,9718,16,3,2,9743,9751,10,9869,9877,10,-1,-1,-1,9751,9754
270,10,10,26,50,103,123,35,20,2,2,51,61,50,139,149,50,-1,-1,-1,61,63
269,10,10,35,10,9832,9853,9726,21,1,2,9751,9761,10,9877,9888,10,-1,-1,-1,9761,9762
268,10,10,32,7,10622,10641,10498,19,1,2,10520,10530,7,10664,10673,7,-1,-1,-1,10530,10532
267,9,9,37,10,9842,9863,9733,21,1,2,9761,9770,10,9888,9900,10,-1,-1,-1,9770,9771
266,2,2,9,29,5602,5606,5492,4,10,2,5499,5501,29,5613,5615,29,-1,-1,-1,5501,5512
265,8,8,28,29,5618,5634,5522,16,1,2,5542,5550,29,5654,5662,29,-1,-1,-1,5550,5551
264,3,3,37,20,7556,7562,7458,6,8,2,7492,7495,20,7596,7599,20,-1,-1,-1,7495,7503
263,3,3,23,6,10943,10947,10806,4,11,2,10826,10829,6,10969,10970,6,-1,-1,-1,10829,10840
262,1,1,5,15,8571,8574,8501,3,8,2,8505,8506,15,8577,8579,15,-1,-1,-1,8506,8515
261,1,1,2,38,3341,3344,3215,3,11,2,3216,3217,38,3344,3346,38,-1,-1,-1,3217,3228
260,3,3,14,27,5989,5995,5840,6,10,2,5851,5854,27,6006,6009,27,-1,-1,-1,5854,5864
259,2,2,39,10,9869,9873,9744,4,8,2,9781,9783,10,9910,9912,10,-1,-1,-1,9783,9792
258,9,9,19,13,9121,9140,9007,19,3,2,9017,9026,13,9149,9159,13,-1,-1,-1,9026,9030
257,2,2,42,18,7970,7973,7834,3,10,2,7874,7876,18,8014,8015,18,-1,-1,-1,7876,7887
256,2,2,18,24,6549,6554,6426,5,9,2,6442,6444,24,6569,6572,24,-1,-1,-1,6444,6454
255,1,1,49,39,3160,3164,2996,4,10,2,3044,3045,39,3210,3213,39,-1,-1,-1,3045,3057
254,1,1,42,50,153,156,72,3,12,2,113,114,50,196,198,50,-1,-1,-1,114,127
253,3,3,21,43,1983,1989,1822,6,11,2,1840,1843,43,2007,2010,43,-1,-1,-1,1843,1855
252,9,9,24,48,621,641,516,20,3,2,531,540,48,654,665,48,-1,-1,-1,540,543
251,2,2,39,24,6565,6568,6450,3,10,2,6487,6489,24,6606,6607,24,-1,-1,-1,6489,6500
250,11,11,35,46,1295,1314,1147,19,2,2,1171,1182,46,1341,1349,46,-1,-1,-1,1182,1184
249,2,2,32,21,7332,7336,7183,4,8,2,7213,7215,21,7366,7368,21,-1,-1,-1,7215,7223
248,2,2,26,18,7916,7920,7790,4,10,2,7814,7816,18,7944,7946,18,-1,-1,-1,7816,7827
247,12,12,26,15,8563,8586,8521,23,2,2,8535,8547,15,8601,8612,15,-1,-1,-1,8547,8549
246,12,12,22,15,8559,8579,8513,20,2,2,8523,8535,15,8593,8601,15,-1,-1,-1,8535,8537
245,3,3,7,41,2444,2450,2342,6,12,2,2346,2349,41,2454,2457,41,-1,-1,-1,2349,2362
244,3,3,4,13,9080,9085,8957,5,10,2,8958,8961,13,9087,9089,13,-1,-1,-1,8961,8972
243,12,12,22,12,9370,9391,9261,21,2,2,9271,9283,12,9404,9413,12,-1,-1,-1,9283,9285
242,2,2,24,41,2467,2471,2362,4,12,2,2384,2386,41,2493,2495,41,-1,-1,-1,2386,2399
241,2,2,26,33,4607,4611,4507,4,12,2,4531,4533,33,4635,4637,33,-1,-1,-1,4533,4545
240,10,10,43,23,6761,6779,6684,18,3,2,6717,6727,23,6814,6822,23,-1,-1,-1,6727,6731
239,2,2,24,30,5398,5401,5283,3,9,2,5305,5307,30,5424,5425,30,-1,-1,-1,5307,5316
238,8,8,35,34,4367,4386,4246,19,2,2,4273,4281,34,4410,4421,34,-1,-1,-1,4281,4283
237,2,2,41,24,6564,6568,6450,4,9,2,6489,6491,24,6607,6609,24,-1,-1,-1,6491,6501
236,8,8,46,24,6572,6591,6465,19,3,2,6503,6511,24,6626,6637,24,-1,-1,-1,6511,6514
235,1,1,22,44,1728,1731,1620,3,9,2,1641,1642,44,1751,1753,44,-1,-1,-1,1642,1652
234,8,8,20,42,2267,2287,2173,20,1,2,2185,2193,42,2295,2307,42,-1,-1,-1,2193,2194
233,10,10,48,14,8883,8905,8742,22,3,2,8780,8790,14,8941,8953,14,-1,-1,-1,8790,8793
232,2,2,4,42,2227,2230,2120,3,11,2,2122,2124,42,2233,2234,42,-1,-1,-1,2124,2135
231,2,2,35,23,6775,6778,6677,3,12,2,6710,6712,23,6812,6813,23,-1,-1,-1,6712,6726
230,11,11,5,11,9581,9602,9500,21,3,2,9494,9505,11,9597,9607,11,-1,-1,-1,9505,9508
229,1,1,50,42,2292,2294,2183,2,9,2,2232,2233,42,2343,2344,42,-1,-1,-1,2233,2243
228,2,2,30,40,2788,2791,2627,3,12,2,2655,2657,40,2820,2821,40,-1,-1,-1,2657,2670
227,3,3,49,43,2068,2073,1905,5,12,2,1951,1954,43,2120,2122,43,-1,-1,-1,1954,1968
226,2,2,37,22,7052,7055,6904,3,9,2,6939,6941,22,7091,7092,22,-1,-1,-1,6941,6950
225,3,3,49,28,5745,5749,5706,4,10,2,5752,5755,28,5797,5798,28,-1,-1,-1,5755,5766
224,8,8,46,24,6560,6580,6457,20,2,2,6495,6503,24,6614,6626,24,-1,-1,-1,6503,6506
223,1,1,35,20,7563,7565,7457,2,12,2,7491,7492,20,7599,7600,20,-1,-1,-1,7492,7505
222,8,8,40,40,2793,2811,2648,18,1,2,2680,2688,40,2841,2851,40,-1,-1,-1,2688,2689
221,10,10,11,2,11641,11663,11529,22,1,2,11530,11540,2,11662,11674,2,-1,-1,-1,11540,11542
220,10,10,17,42,2249,2270,2156,21,2,2,2163,2173,42,2276,2287,42,-1,-1,-1,2173,2176
219,9,9,7,37,3600,3621,3498,21,2,2,3496,3505,37,3616,3628,37,-1,-1,-1,3505,3507
218,2,2,40,49,398,403,269,5,11,2,307,309,49,440,443,49,-1,-1,-1,309,321
217,3,3,31,15,8579,8583,8522,4,11,2,8550,8553,15,8613,8614,15,-1,-1,-1,8553,8565
216,9,9,25,39,3130,3148,2975,18,2,2,2991,3000,39,3164,3173,39,-1,-1,-1,3000,3002
215,2,2,38,17,8269,8273,8108,4,8,2,8144,8146,17,8309,8311,17,-1,-1,-1,8146,8154
214,12,12,4,6,10867,10887,10746,20,2,2,10738,10750,6,10883,10891,6,-1,-1,-1,10750,10752
213,10,10,8,13,9082,9100,8980,18,2,2,8978,8988,13,9100,9108,13,-1,-1,-1,8988,8990
212,10,10,22,44,1710,1729,1619,19,2,2,1631,1641,44,1742,1751,44,-1,-1,-1,1641,1643
211,2,2,24,3,11427,11431,11331,4,10,2,11353,11355,3,11453,11455,3,-1,-1,-1,11355,11365
210,12,12,38,33,4616,4640,4542,24,2,2,4568,4580,33,4666,4678,33,-1,-1,-1,4580,4582
209,3,3,45,42,2293,2298,2187,5,9,2,2229,2232,42,2341,2343,42,-1,-1,-1,2232,2241
208,2,2,40,12,9407,9410,9281,3,9,2,9319,9321,12,9449,9450,12,-1,-1,-1,9321,9330
207,1,1,47,36,3893,3897,3787,4,12,2,3833,3834,36,3941,3944,36,-1,-1,-1,3834,3847
206,3,3,7,37,3618,3623,3489,5,12,2,3493,3496,37,3628,3630,37,-1,-1,-1,3496,3508
205,10,10,38,7,10627,10646,10505,19,3,2,10533,10543,7,10675,10684,7,-1,-1,-1,10543,10546
204,10,10,20,41,2443,2461,2358,18,1,2,2368,2378,41,2473,2481,41,-1,-1,-1,2378,2379
203,1,1,25,17,8249,8253,8078,4,12,2,8102,8103,17,8275,8278,17,-1,-1,-1,8103,8116
202,2,2,19,29,5630,5635,5514,5,11,2,5531,5533,29,5651,5654,29,-1,-1,-1,5533,5545
201,3,3,4,47,866,871,708,5,9,2,709,712,47,873,875,47,-1,-1,-1,712,721
200,2,2,22,47,909,913,751,4,11,2,771,773,47,933,935,47,-1,-1,-1,773,785
199,1,1,25,7,10618,10620,10477,2,8,2,10501,10502,7,10644,10645,7,-1,-1,-1,10502,10510
198,2,2,38,20,7562,7567,7459,5,11,2,7495,7497,20,7602,7605,20,-1,-1,-1,7497,7510
197,11,11,42,20,7552,7574,7468,22,1,2,7499,7510,20,7605,7616,20,-1,-1,-1,7510,7511
196,9,9,33,17,8236,8255,8089,19,1,2,8113,8122,17,8278,8288,17,-1,-1,-1,8122,8123
195,1,1,18,25,6350,6354,6286,4,8,2,6303,6304,25,6369,6372,25,-1,-1,-1,6304,6313
194,1,1,5,12,9344,9347,9208,3,12,2,9212,9213,12,9350,9352,12,-1,-1,-1,9213,9226
193,2,2,4,7,10585,10588,10442,3,12,2,10444,10446,7,10591,10592,7,-1,-1,-1,10446,10458
192,2,2,29,6,10946,10951,10808,5,11,2,10835,10837,6,10977,10980,6,-1,-1,-1,10837,10849
191,9,9,38,48,642,660,529,18,2,2,558,567,48,689,698,48,-1,-1,-1,567,570
190,9,9,46,41,2471,2488,2394,17,3,2,2431,2440,41,2526,2534,41,-1,-1,-1,2440,2444
189,3,3,16,37,3630,3635,3515,5,8,2,3528,3531,37,3649,3651,37,-1,-1,-1,3531,3539
188,1,1,8,6,10914,10917,10774,3,12,2,10781,10782,6,10923,10925,6,-1,-1,-1,10782,10794
187,2,2,45,40,2804,2809,2645,5,12,2,2688,2690,40,2851,2854,40,-1,-1,-1,2690,2702
186,9,9,31,27,6010,6027,5864,17,3,2,5886,5895,27,6050,6058,27,-1,-1,-1,5895,5898
185,2,2,17,29,5629,5634,5514,5,12,2,5529,5531,29,5648,5651,29,-1,-1,-1,5531,5544
184,11,11,11,5,11106,11128,11038,22,1,2,11038,11049,5,11128,11139,5,-1,-1,-1,11049,11050
183,8,8,44,21,7363,7379,7230,16,3,2,7266,7274,21,7415,7423,21,-1,-1,-1,7274,7277
182,2,2,33,32,4859,4862,4734,3,9,2,4765,4767,32,4894,4895,32,-1,-1,-1,4767,4776
181,8,8,7,43,1965,1983,1815,18,3,2,1814,1822,43,1980,1990,43,-1,-1,-1,1822,1826
180,3,3,49,21,7374,7380,7232,6,8,2,7278,7281,21,7426,7429,21,-1,-1,-1,7281,7289
179,11,11,23,3,11411,11430,11330,19,1,2,11342,11353,3,11445,11453,3,-1,-1,-1,11353,11354
178,9,9,4,11,9575,9592,9487,17,3,2,9482,9491,11,9588,9596,11,-1,-1,-1,9491,9494
177,12,12,43,32,4886,4910,4773,24,2,2,4804,4816,32,4941,4953,32,-1,-1,-1,4816,4818
176,2,2,12,10,9814,9817,9695,3,12,2,9705,9707,10,9828,9829,10,-1,-1,-1,9707,9720
175,2,2,9,42,2233,2237,2132,4,9,2,2139,2141,42,2244,2246,42,-1,-1,-1,2141,2151
174,1,1,40,44,1758,1761,1641,3,12,2,1680,1681,44,1799,1801,44,-1,-1,-1,1681,1695
173,11,11,22,18,7900,7921,7792,21,3,2,7803,7814,18,7933,7943,18,-1,-1,-1,7814,7817
172,3,3,28,50,138,144,54,6,12,2,79,82,50,169,172,50,-1,-1,-1,82,94
171,3,3,23,2,11675,11681,11546,6,12,2,11566,11569,2,11701,11704,2,-1,-1,-1,11569,11581
170,10,10,38,21,7330,7350,7195,20,2,2,7223,7233,21,7378,7388,21,-1,-1,-1,7233,7235
169,2,2,32,24,6571,6574,6455,3,11,2,6485,6487,24,6605,6606,24,-1,-1,-1,6487,6498
168,1,1,16,45,1503,1505,1405,2,11,2,1420,1421,45,1520,1521,45,-1,-1,-1,1421,1433
167,8,8,50,20,7573,7590,7485,17,1,2,7527,7535,20,7631,7640,20,-1,-1,-1,7535,7537
166,9,9,12,49,315,335,206,20,3,2,209,218,49,336,347,49,-1,-1,-1,218,221
165,10,10,35,22,7037,7056,6904,19,1,2,6929,6939,22,7082,7091,22,-1,-1,-1,6939,6940
164,12,12,5,45,1472,1493,1391,21,3,2,1384,1396,45,1489,1498,45,-1,-1,-1,1396,1399
163,2,2,42,19,7695,7699,7643,4,8,2,7683,7685,19,7739,7741,19,-1,-1,-1,7685,7693
162,2,2,3,13,9079,9084,8955,5,10,2,8956,8958,13,9084,9087,13,-1,-1,-1,8958,8969
161,10,10,16,11,9591,9610,9508,19,2,2,9514,9524,11,9617,9626,11,-1,-1,-1,9524,9526
160,9,9,41,21,7354,7374,7225,20,3,2,7257,7266,21,7404,7415,21,-1,-1,-1,7266,7269
159,3,3,1,37,3601,3607,3480,6,9,2,3478,3481,37,3605,3608,37,-1,-1,-1,3481,3490
158,2,2,5,18,7886,7890,7760,4,12,2,7763,7765,18,7893,7895,18,-1,-1,-1,7765,7777
157,3,3,39,22,7051,7057,6907,6,9,2,6943,6946,22,7093,7096,22,-1,-1,-1,6946,6956
156,9,9,5,19,7697,7718,7657,21,3,2,7653,7662,19,7711,7723,19,-1,-1,-1,7662,7665
155,3,3,48,18,7967,7971,7843,4,11,2,7888,7891,18,8018,8019,18,-1,-1,-1,7891,7903
154,11,11,35,35,4108,4127,3994,19,1,2,4018,4029,35,4154,4162,35,-1,-1,-1,4029,4030
153,9,9,39,13,9148,9165,9036,17,3,2,9066,9075,13,9196,9204,13,-1,-1,-1,9075,9079
152,1,1,18,4,11269,11273,11208,4,9,2,11225,11226,4,11288,11291,4,-1,-1,-1,11226,11235
151,1,1,5,1,11857,11861,11786,4,8,2,11790,11791,1,11863,11866,1,-1,-1,-1,11791,11799
150,11,11,26,42,2271,2293,2180,22,3,2,2195,2206,42,2308,2319,42,-1,-1,-1,2206,2209
149,12,12,2,5,11091,11112,11026,21,1,2,11016,11028,5,11105,11114,5,-1,-1,-1,11028,11029
148,1,1,25,50,110,114,25,4,10,2,49,50,50,136,139,50,-1,-1,-1,50,60
147,2,2,28,21,7322,7325,7170,3,10,2,7196,7198,21,7352,7353,21,-1,-1,-1,7198,7209
146,10,10,26,37,3621,3640,3519,19,3,2,3535,3545,37,3657,3666,37,-1,-1,-1,3545,3549
145,12,12,10,37,3610,3630,3509,20,2,2,3507,3519,37,3632,3640,37,-1,-1,-1,3519,3521
144,11,11,16,15,8558,8577,8507,19,3,2,8512,8523,15,8585,8593,15,-1,-1,-1,8523,8526
143,8,8,40,27,6052,6071,5900,19,2,2,5932,5940,27,6100,6111,27,-1,-1,-1,5940,5942
142,12,12,7,49,305,329,3,24,3,3,7,10,49,199,208,49,324,336,49,208,211
141,10,10,29,4,11259,11279,11213,20,3,2,11232,11242,4,11298,11308,4,-1,-1,-1,11242,11246
140,2,2,27,25,6349,6352,6284,3,8,2,6309,6311,25,6378,6379,25,-1,-1,-1,6311,6320
139,3,3,49,32,4903,4908,4772,5,9,2,4818,4821,32,4955,4957,32,-1,-1,-1,4821,4831
138,2,2,16,48,609,612,490,3,8,2,504,506,48,627,628,48,-1,-1,-1,506,514
137,8,8,43,43,2045,2064,1905,19,3,2,1940,1948,43,2096,2107,43,-1,-1,-1,1948,1952
136,3,3,28,1,11870,11876,11802,6,12,2,11827,11830,1,11901,11904,1,-1,-1,-1,11830,11842
135,12,12,18,38,3353,3377,3248,24,2,2,3254,3266,38,3383,3395,38,-1,-1,-1,3266,3268
134,2,2,8,41,2450,2455,2343,5,11,2,2349,2351,41,2460,2463,41,-1,-1,-1,2351,2363
133,10,10,4,39,3033,3051,2877,18,1,2,2871,2881,39,3047,3055,39,-1,-1,-1,2881,2882
132,2,2,19,5,11142,11146,11056,4,8,2,11073,11075,5,11163,11165,5,-1,-1,-1,11075,11083
131,1,1,29,35,4107,4109,3977,2,9,2,4005,4006,35,4137,4138,35,-1,-1,-1,4006,4016
130,2,2,10,44,1695,1698,1590,3,11,2,1598,1600,44,1707,1708,44,-1,-1,-1,1600,1611
129,12,12,23,50,89,113,23,24,1,2,34,46,50,124,136,50,-1,-1,-1,46,48
128,11,11,3,27,5940,5963,5809,23,3,2,5801,5812,27,5954,5966,27,-1,-1,-1,5812,5815
127,1,1,20,7,10622,10624,10479,2,8,2,10498,10499,7,10643,10644,7,-1,-1,-1,10499,10508
126,2,2,22,13,9135,9139,9009,4,9,2,9029,9031,13,9159,9161,13,-1,-1,-1,9031,9040
125,1,1,48,36,3887,3890,3787,3,9,2,3834,3835,36,3936,3938,36,-1,-1,-1,3835,3844
124,3,3,27,15,8582,8586,8523,4,10,2,8547,8550,15,8612,8613,15,-1,-1,-1,8550,8560
123,11,11,39,46,1301,1324,1158,23,3,2,1186,1197,46,1351,1363,46,-1,-1,-1,1197,1200
122,10,10,50,19,7694,7713,7653,19,1,2,7693,7703,19,7754,7763,19,-1,-1,-1,7703,7704
121,11,11,5,25,6320,6342,6275,22,2,2,6269,6280,25,6336,6347,25,-1,-1,-1,6280,6282
120,9,9,38,32,4863,4883,4748,20,1,2,4777,4786,32,4910,4921,32,-1,-1,-1,4786,4787
119,8,8,43,16,8422,8440,8372,18,3,2,8407,8415,16,8473,8483,16,-1,-1,-1,8415,8419
118,2,2,21,17,8223,8228,8066,5,9,2,8085,8087,17,8246,8249,17,-1,-1,-1,8087,8098
117,2,2,45,20,7582,7586,7482,4,9,2,7525,7527,20,7629,7631,20,-1,-1,-1,7527,7536
116,3,3,40,3,11464,11468,11371,4,11,2,11408,11411,3,11507,11508,3,-1,-1,-1,11411,11422
115,2,2,18,6,10923,10928,10782,5,9,2,10798,10800,6,10943,10946,6,-1,-1,-1,10800,10811
114,12,12,36,3,11440,11462,11364,22,1,2,11388,11400,3,11488,11498,3,-1,-1,-1,11400,11401
113,3,3,32,12,9389,9393,9266,4,8,2,9295,9298,12,9424,9425,12,-1,-1,-1,9298,9306
112,1,1,30,31,5161,5165,5026,4,9,2,5055,5056,31,5192,5195,31,-1,-1,-1,5056,5065
111,9,9,34,43,2009,2026,1866,17,1,2,1891,1900,43,2052,2060,43,-1,-1,-1,1900,1901
110,9,9,26,39,3138,3156,2983,18,3,2,3000,3009,39,3173,3182,39,-1,-1,-1,3009,3012
109,2,2,41,20,7557,7561,7458,4,8,2,7497,7499,20,7600,7602,20,-1,-1,-1,7499,7507
108,2,2,11,42,2241,2246,2132,5,12,2,2141,2143,42,2254,2257,42,-1,-1,-1,2143,2156
107,2,2,17,11,9619,9623,9519,4,9,2,9534,9536,11,9638,9640,11,-1,-1,-1,9536,9545
106,10,10,5,23,6727,6749,6645,22,1,2,6640,6650,23,6742,6754,23,-1,-1,-1,6650,6651
105,3,3,32,21,7333,7338,7181,5,10,2,7210,7213,21,7368,7370,21,-1,-1,-1,7213,7224
104,3,3,26,10,9836,9841,9707,5,12,2,9730,9733,10,9865,9867,10,-1,-1,-1,9733,9745
103,10,10,38,10,9854,9872,9743,18,3,2,9771,9781,10,9902,9910,10,-1,-1,-1,9781,9784
102,3,3,8,42,2231,2236,2131,5,8,2,2136,2139,42,2242,2244,42,-1,-1,-1,2139,2147
101,3,3,46,50,149,153,75,4,12,2,118,121,50,198,199,50,-1,-1,-1,121,135
100,9,9,2,21,7273,7290,7137,17,2,2,7130,7139,21,7284,7292,21,-1,-1,-1,7139,7141
99,3,3,1,27,5947,5953,5800,6,8,2,5798,5801,27,5951,5954,27,-1,-1,-1,5801,5809
98,11,11,15,7,10609,10628,10483,19,3,2,10487,10498,7,10635,10643,7,-1,-1,-1,10498,10501
97,2,2,11,41,2444,2449,2342,5,9,2,2351,2353,41,2457,2460,41,-1,-1,-1,2353,2362
96,2,2,3,19,7718,7721,7650,3,12,2,7651,7653,19,7723,7724,19,-1,-1,-1,7653,7666
95,9,9,36,37,3649,3669,3543,20,1,2,3570,3579,37,3694,3705,37,-1,-1,-1,3579,3580
94,8,8,25,10,9809,9829,9705,20,1,2,9722,9730,10,9842,9854,10,-1,-1,-1,9730,9731
93,3,3,39,43,2027,2032,1876,5,12,2,1912,1915,43,2069,2071,43,-1,-1,-1,1915,1928
92,11,11,19,36,3871,3890,3782,19,3,2,3790,3801,36,3901,3909,36,-1,-1,-1,3801,3804
91,2,2,39,49,395,398,268,3,10,2,305,307,49,436,437,49,-1,-1,-1,307,317
90,8,8,2,46,1215,1231,1054,16,2,2,1048,1056,46,1225,1233,46,-1,-1,-1,1056,1058
89,2,2,13,30,5407,5410,5287,3,10,2,5298,5300,30,5422,5423,30,-1,-1,-1,5300,5311
88,1,1,47,4,11271,11274,11210,3,8,2,11256,11257,4,11319,11321,4,-1,-1,-1,11257,11265
87,2,2,1,8,10325,10330,10215,5,10,2,10214,10216,8,10328,10331,8,-1,-1,-1,10216,10226
86,11,11,9,1,11847,11866,11794,19,3,2,11792,11803,1,11867,11875,1,-1,-1,-1,11803,11806
85,3,3,45,3,11460,11464,11370,4,8,2,11412,11415,3,11508,11509,3,-1,-1,-1,11415,11423
84,9,9,13,37,3618,3636,3515,18,3,2,3519,3528,37,3640,3649,37,-1,-1,-1,3528,3531
83,11,11,19,35,4053,4072,3942,19,3,2,3950,3961,35,4083,4091,35,-1,-1,-1,3961,3965
82,1,1,47,34,4428,4430,4290,2,11,2,4336,4337,34,4476,4477,34,-1,-1,-1,4337,4348
81,1,1,8,30,5389,5392,5271,3,8,2,5278,5279,30,5398,5400,30,-1,-1,-1,5279,5287
80,3,3,38,5,11128,11133,11042,5,12,2,11077,11080,5,11169,11171,5,-1,-1,-1,11080,11093
79,2,2,11,5,11112,11117,11027,5,9,2,11036,11038,5,11125,11128,5,-1,-1,-1,11038,11048
78,1,1,13,9,10098,10100,9953,2,11,2,9965,9966,9,10112,10113,9,-1,-1,-1,9966,9978
77,11,11,20,17,8198,8217,8055,19,2,2,8064,8075,17,8229,8237,17,-1,-1,-1,8075,8077
76,1,1,2,44,1688,1692,1582,4,9,2,1583,1584,44,1691,1694,44,-1,-1,-1,1584,1593
75,9,9,35,2,11696,11715,11579,19,1,2,11605,11614,2,11740,11750,2,-1,-1,-1,11614,11615
74,10,10,8,21,7274,7296,7141,22,3,2,7139,7149,21,7292,7304,21,-1,-1,-1,7149,7152
73,2,2,11,8,10349,10353,10240,4,9,2,10249,10251,8,10362,10364,8,-1,-1,-1,10251,10260
72,10,10,28,50,122,141,51,19,2,2,69,79,50,160,169,50,-1,-1,-1,79,81
71,12,12,47,22,7040,7061,6917,21,3,2,6952,6964,22,7099,7108,22,-1,-1,-1,6964,6967
70,3,3,5,44,1687,1691,1585,4,8,2,1587,1590,44,1695,1696,44,-1,-1,-1,1590,1598
69,3,3,20,4,11270,11275,11209,5,9,2,11226,11229,4,11293,11295,4,-1,-1,-1,11229,11240
68,3,3,35,39,3169,3173,3004,4,9,2,3036,3039,39,3207,3208,39,-1,-1,-1,3039,3049
67,1,1,10,50,35,39,1,4,12,2,10,11,50,46,49,50,-1,-1,-1,11,24
66,3,3,48,18,7964,7970,7840,6,12,2,7885,7888,18,8015,8018,18,-1,-1,-1,7888,7900
65,3,3,10,18,7894,7900,7768,6,11,2,7775,7778,18,7907,7910,18,-1,-1,-1,7778,7789
64,8,8,50,33,4630,4648,4550,18,2,2,4592,4600,33,4688,4698,33,-1,-1,-1,4600,4602
63,10,10,23,31,5142,5160,5018,18,3,2,5031,5041,31,5175,5183,31,-1,-1,-1,5041,5044
62,2,2,33,41,2471,2476,2379,5,8,2,2410,2412,41,2506,2509,41,-1,-1,-1,2412,2420
61,8,8,4,48,577,594,3,17,2,3,6,7,48,471,478,48,589,598,48,478,480
60,11,11,22,47,892,911,749,19,3,2,760,771,47,925,933,47,-1,-1,-1,771,774
59,3,3,10,39,3042,3046,2875,4,8,2,2882,2885,39,3055,3056,39,-1,-1,-1,2885,2893
58,1,1,43,33,4635,4637,4538,2,12,2,4580,4581,33,4679,4680,33,-1,-1,-1,4581,4594
57,11,11,17,12,9337,9357,9229,20,3,2,9235,9246,12,9365,9374,12,-1,-1,-1,9246,9249
56,1,1,41,15,8582,8586,8525,4,11,2,8565,8566,15,8624,8627,15,-1,-1,-1,8566,8578
55,8,8,13,34,4344,4362,4228,18,2,2,4233,4241,34,4365,4375,34,-1,-1,-1,4241,4243
54,12,12,26,14,8831,8854,8695,23,1,2,8709,8721,14,8869,8880,14,-1,-1,-1,8721,8722
53,9,9,41,10,9862,9883,9751,21,2,2,9783,9792,10,9912,9924,10,-1,-1,-1,9792,9794
52,12,12,40,21,7336,7356,7205,20,1,2,7233,7245,21,7388,7396,21,-1,-1,-1,7245,7246
51,2,2,7,30,5391,5395,5271,4,11,2,5276,5278,30,5400,5402,30,-1,-1,-1,5278,5291
50,12,12,16,1,11847,11867,11799,20,1,2,11803,11815,1,11875,11883,1,-1,-1,-1,11815,11816
49,10,10,17,47,883,901,737,18,2,2,744,754,47,910,918,47,-1,-1,-1,754,757
48,10,10,34,50,128,146,66,18,3,2,90,100,50,172,180,50,-1,-1,-1,100,103
47,11,11,23,36,3875,3894,3789,19,2,2,3801,3812,36,3909,3917,36,-1,-1,-1,3812,3814
46,2,2,14,2,11658,11661,11528,3,10,2,11540,11542,2,11674,11675,2,-1,-1,-1,11542,11552
45,8,8,13,21,7291,7311,7159,20,1,2,7164,7172,21,7312,7324,21,-1,-1,-1,7172,7173
44,8,8,8,36,3850,3869,3761,19,2,2,3761,3769,36,3866,3877,36,-1,-1,-1,3769,3771
43,3,3,4,44,1697,1703,1583,6,11,2,1584,1587,44,1704,1707,44,-1,-1,-1,1587,1600
42,9,9,37,27,6043,6063,5895,20,2,2,5923,5932,27,6089,6100,27,-1,-1,-1,5932,5934
41,3,3,8,16,8424,8428,8359,4,8,2,8364,8367,16,8435,8436,16,-1,-1,-1,8367,8375
40,1,1,45,3,11463,11466,11367,3,11,2,11411,11412,3,11509,11511,3,-1,-1,-1,11412,11424
39,2,2,17,39,3079,3084,2905,5,10,2,2920,2922,39,3098,3101,39,-1,-1,-1,2922,2933
38,10,10,3,3,11410,11428,11328,18,3,2,11321,11331,3,11423,11431,3,-1,-1,-1,11331,11334
37,2,2,35,19,7715,7719,7648,4,12,2,7681,7683,19,7752,7754,19,-1,-1,-1,7683,7696
36,2,2,23,46,1280,1283,1109,3,11,2,1130,1132,46,1305,1306,46,-1,-1,-1,1132,1143
35,12,12,2,46,1201,1223,1046,22,3,2,1036,1048,46,1215,1225,46,-1,-1,-1,1048,1051
34,2,2,12,36,3874,3879,3767,5,11,2,3777,3779,36,3888,3891,36,-1,-1,-1,3779,3790
33,1,1,2,49,205,207,1,2,9,2,2,3,49,208,209,49,-1,-1,-1,3,12
32,2,2,25,22,7008,7013,6852,5,8,2,6875,6877,22,7035,7038,22,-1,-1,-1,6877,6886
31,10,10,30,28,5742,5760,5715,18,2,2,5735,5745,28,5782,5790,28,-1,-1,-1,5745,5747
30,12,12,17,14,8781,8805,8645,24,3,2,8650,8662,14,8810,8822,14,-1,-1,-1,8662,8665
29,2,2,14,46,1238,1243,1066,5,8,2,1078,1080,46,1254,1257,46,-1,-1,-1,1080,1088
28,10,10,25,39,3117,3139,2966,22,3,2,2981,2991,39,3152,3164,39,-1,-1,-1,2991,2994
27,12,12,25,10,9796,9817,9697,21,1,2,9710,9722,10,9833,9842,10,-1,-1,-1,9722,9723
26,12,12,23,39,3077,3100,2926,23,1,2,2937,2949,39,3112,3123,39,-1,-1,-1,2949,2950
25,2,2,20,20,7561,7566,7458,5,8,2,7476,7478,20,7583,7586,20,-1,-1,-1,7478,7487
24,3,3,37,27,6046,6052,5886,6,8,2,5920,5923,27,6086,6089,27,-1,-1,-1,5923,5932
23,1,1,27,10,9839,9842,9707,3,11,2,9733,9734,10,9867,9869,10,-1,-1,-1,9734,9746
22,11,11,31,41,2453,2472,2375,19,3,2,2395,2406,41,2495,2503,41,-1,-1,-1,2406,2409
21,2,2,17,10,9811,9816,9693,5,11,2,9708,9710,10,9830,9833,10,-1,-1,-1,9710,9722
20,2,2,21,47,895,900,736,5,8,2,755,757,47,918,921,47,-1,-1,-1,757,765
19,11,11,29,37,3629,3650,3528,21,3,2,3546,3557,37,3669,3679,37,-1,-1,-1,3557,3560
18,8,8,14,24,6516,6532,6403,16,1,2,6409,6417,24,6538,6546,24,-1,-1,-1,6417,6418
17,1,1,9,7,10582,10586,10442,4,8,2,10450,10451,7,10592,10595,7,-1,-1,-1,10451,10459
16,10,10,45,9,10116,10134,10003,18,2,2,10038,10048,9,10171,10179,9,-1,-1,-1,10048,10050
15,2,2,29,18,7916,7921,7793,5,12,2,7820,7822,18,7947,7950,18,-1,-1,-1,7822,7835
14,8,8,40,38,3404,3421,3289,17,2,2,3321,3329,38,3452,3461,38,-1,-1,-1,3329,3331
13,3,3,30,34,4374,4380,4243,6,8,2,4270,4273,34,4407,4410,34,-1,-1,-1,4273,4281
12,8,8,26,16,8411,8428,8361,17,3,2,8379,8387,16,8445,8454,16,-1,-1,-1,8387,8390
11,2,2,14,49,343,347,217,4,8,2,229,231,49,359,361,49,-1,-1,-1,231,239
10,12,12,10,32,4817,4838,4705,21,1,2,4703,4715,32,4839,4848,32,-1,-1,-1,4715,4716
9,3,3,27,22,7020,7025,6864,5,8,2,6888,6891,22,7050,7052,22,-1,-1,-1,6891,6899
8,11,11,2,19,7690,7709,7649,19,3,2,7640,7651,19,7703,7711,19,-1,-1,-1,7651,7654
7,12,12,36,38,3379,3402,3270,23,1,2,3294,3306,38,3427,3438,38,-1,-1,-1,3306,3307
6,11,11,24,39,3100,3119,2945,19,2,2,2958,2969,39,3135,3143,39,-1,-1,-1,2969,2971
5,12,12,45,8,10370,10394,10279,24,1,2,10312,10324,8,10427,10439,8,-1,-1,-1,10324,10325
4,11,11,20,6,10915,10935,10791,20,3,2,10800,10811,6,10946,10955,6,-1,-1,-1,10811,10814
3,9,9,5,25,6311,6331,6264,20,2,2,6260,6269,25,6325,6336,25,-1,-1,-1,6269,6271
2,9,9,30,10,9815,9835,9713,20,1,2,9734,9743,10,9854,9865,10,-1,-1,-1,9743,9744
1,3,3,1,36,3831,3836,3734,5,12,2,3732,3735,36,3835,3837,36,-1,-1,-1,3735,3747
0,8,8,34,2,11689,11706,11571,17,1,2,11597,11605,2,11731,11740,2,-1,-1,-1,11605,11606
